Date,Description,Deposits,Withdrawls,Balance
2020-08-20,Cash,97540.0,0.0,170542.01
2020-08-20,Commission,0.0,34108.4,136433.61
2020-08-20,ATM,41.0,0.0,136474.61
2020-08-20,Interest,50.0,0.0,136524.61
2020-08-20,Commission,0.0,34131.15,102393.46
2020-08-20,Reversal,0.0,17065.58,85327.88
2020-08-20,Reversal,204765.0,0.0,290092.88
2020-08-20,Cheque,53121.0,0.0,343213.88
2020-08-20,NEFT,7.1,0.0,343220.98
2020-08-20,IMPS,3.46,0.0,343224.44
2020-08-20,Transfer,3.0,0.0,343227.44
2020-08-20,RTGS,223558.62,0.0,566786.06
2020-08-20,ATM,496536.75,0.0,1063322.81
2020-08-20,Reversal,770726.0,0.0,1834048.81
2020-08-20,Interest,0.0,1834048.81,0.0
2020-08-20,Bill,0.01,0.0,0.01
2020-08-20,Commission,18690.68,0.0,18690.69
2020-08-20,Cash,0.0,1869.07,16821.62
2020-08-20,Cheque,190.0,0.0,17011.62
2020-08-20,Tax,55.0,0.0,17066.62
2020-08-20,ATM,0.0,1896.29,15170.33
2020-08-20,Transfer,0.0,3034.07,12136.26
2020-08-20,ATM,26.6,0.0,12162.86
2020-08-20,ATM,0.0,6081.43,6081.43
2020-08-20,NEFT,1986737.8,0.0,1992819.23
2020-08-20,Reversal,0.0,664273.08,1328546.15
2020-08-20,Cash,3.81,0.0,1328549.96
2020-08-20,RTGS,1474.0,0.0,1330023.96
2020-08-20,Interest,0.0,147780.44,1182243.52
2020-08-20,Bill,0.0,168891.93,1013351.59
2020-08-20,Transfer,191.0,0.0,1013542.59
2020-08-20,Interest,22709.69,0.0,1036252.28
2020-08-20,ATM,44.0,0.0,1036296.28
2020-08-20,Interest,54.05,0.0,1036350.33
2020-08-20,IMPS,178.0,0.0,1036528.33
2020-08-20,ATM,0.0,518264.17,518264.16
2020-08-20,Miscellaneous,0.0,103652.83,414611.33
2020-08-20,Cash,16.0,0.0,414627.33
2020-08-20,Transfer,0.0,46069.7,368557.63
2020-08-20,Debit Card,0.0,184278.82,184278.82
2020-08-20,NEFT,0.0,30713.14,153565.68
2020-08-21,Cash,14418.1,0.0,167983.78
2020-08-21,RTGS,0.0,33596.76,134387.02
2020-08-21,Purchase,0.0,44795.67,89591.35
2020-08-21,Debit Card,492.86,0.0,90084.21
2020-08-21,ATM,0.0,90084.21,0.0
2020-08-21,RTGS,8.0,0.0,8.0
2020-08-21,Bill,7099.0,0.0,7107.0
2020-08-21,Purchase,2.6,0.0,7109.6
2020-08-21,NEFT,772.4,0.0,7882.0
2020-08-21,Bill,1335369.25,0.0,1343251.25
2020-08-21,NEFT,31237.0,0.0,1374488.25
2020-08-21,Transfer,0.0,137448.83,1237039.42
2020-08-21,IMPS,0.0,412346.47,824692.95
2020-08-21,Commission,0.0,412346.48,412346.48
2020-08-21,Bill,0.0,51543.31,360803.17
2020-08-22,NEFT,0.0,90200.79,270602.38
2020-08-22,NEFT,6.6,0.0,270608.98
2020-08-22,Reversal,0.0,45101.5,225507.48
2020-08-22,RTGS,217183.1,0.0,442690.58
2020-08-22,RTGS,0.0,221345.29,221345.29
2020-08-22,Debit Card,17021.0,0.0,238366.29
2020-08-22,Commission,128690.25,0.0,367056.54
2020-08-22,Reversal,3749.1,0.0,370805.64
2020-08-22,Miscellaneous,2585.2,0.0,373390.84
2020-08-22,NEFT,1339.0,0.0,374729.84
2020-08-22,Purchase,0.0,93682.46,281047.38
2020-08-22,Bill,335.7,0.0,281383.08
2020-08-22,Bill,0.0,35172.89,246210.2
2020-08-22,NEFT,0.0,24621.02,221589.18
2020-08-22,NEFT,0.0,36931.53,184657.65
2020-08-22,RTGS,0.0,92328.83,92328.82
2020-08-22,IMPS,39082.7,0.0,131411.52
2020-08-22,Interest,16.48,0.0,131428.0
2020-08-22,ATM,0.0,18775.43,112652.57
2020-08-22,Debit Card,1001957.0,0.0,1114609.57
2020-08-22,Commission,0.0,1114609.57,0.0
2020-08-22,Interest,229611.0,0.0,229611.0
2020-08-22,Purchase,21743.97,0.0,251354.97
2020-08-22,Purchase,0.0,125677.49,125677.48
2020-08-22,Purchase,272.0,0.0,125949.48
2020-08-22,Debit Card,306.0,0.0,126255.48
2020-08-22,Tax,0.0,42085.16,84170.32
2020-08-22,Cheque,2408.0,0.0,86578.32
2020-08-22,Interest,36.68,0.0,86615.0
2020-08-22,Purchase,59.51,0.0,86674.51
2020-08-22,Transfer,58.49,0.0,86733.0
2020-08-22,Bill,24976.6,0.0,111709.6
2020-08-22,Tax,27.0,0.0,111736.6
2020-08-22,NEFT,0.0,18622.77,93113.83
2020-08-22,Transfer,6.0,0.0,93119.83
2020-08-22,RTGS,4.0,0.0,93123.83
2020-08-22,NEFT,0.0,46561.92,46561.92
2020-08-22,ATM,3925.0,0.0,50486.92
2020-08-22,IMPS,7.2,0.0,50494.12
2020-08-22,IMPS,0.0,16831.37,33662.75
2020-08-22,IMPS,74284.97,0.0,107947.72
2020-08-22,ATM,0.0,15421.1,92526.62
2020-08-22,Bill,0.0,18505.32,74021.3
2020-08-22,Bill,6.0,0.0,74027.3
2020-08-22,Purchase,0.0,7402.73,66624.57
2020-08-22,Cash,0.0,66624.57,0.0
2020-08-22,Purchase,16267.0,0.0,16267.0
2020-08-22,Commission,0.0,1626.7,14640.3
2020-08-22,NEFT,0.0,1626.7,13013.6
2020-08-22,ATM,2599.6,0.0,15613.2
2020-08-22,Miscellaneous,3420.2,0.0,19033.4
2020-08-22,Debit Card,0.0,4758.35,14275.05
2020-08-22,Reversal,0.0,4758.35,9516.7
2020-08-22,Cheque,0.0,1359.53,8157.17
2020-08-22,Commission,0.0,906.35,7250.82
2020-08-22,Debit Card,0.0,1450.16,5800.66
2020-08-22,Purchase,0.0,580.07,5220.59
2020-08-22,Interest,0.0,1044.12,4176.47
2020-08-22,Miscellaneous,0.0,4176.47,0.0
2020-08-22,Miscellaneous,16915.8,0.0,16915.8
2020-08-22,Cheque,0.0,2819.3,14096.5
2020-08-22,IMPS,0.0,7048.25,7048.25
2020-08-23,Purchase,1432.0,0.0,8480.25
2020-08-23,Miscellaneous,0.0,848.03,7632.22
2020-08-23,IMPS,1807354.0,0.0,1814986.22
2020-08-23,Interest,0.0,604995.41,1209990.81
2020-08-23,Bill,0.0,120999.08,1088991.73
2020-08-23,Debit Card,1.7,0.0,1088993.43
2020-08-23,Reversal,0.0,155570.49,933422.94
2020-08-23,Bill,0.0,133346.13,800076.81
2020-08-23,Cash,0.0,114296.69,685780.12
2020-08-23,Commission,0.0,171445.03,514335.09
2020-08-23,ATM,28.0,0.0,514363.09
2020-08-23,ATM,0.0,73480.44,440882.65
2020-08-23,NEFT,72005.25,0.0,512887.9
2020-08-23,Transfer,1.6,0.0,512889.5
2020-08-23,RTGS,0.0,56987.72,455901.78
2020-08-23,Purchase,80.79,0.0,455982.57
2020-08-23,RTGS,0.0,75997.1,379985.48
2020-08-23,Reversal,5277.66,0.0,385263.14
2020-08-23,Reversal,0.0,128421.05,256842.09
2020-08-23,Cash,0.0,64210.52,192631.57
2020-08-23,RTGS,0.0,27518.8,165112.77
2020-08-23,ATM,271.0,0.0,165383.77
2020-08-23,ATM,0.0,55127.92,110255.85
2020-08-23,Cheque,0.0,11025.59,99230.26
2020-08-23,Reversal,10196.72,0.0,109426.98
2020-08-23,ATM,0.0,109426.98,0.0
2020-08-23,Cash,1078.5,0.0,1078.5
2020-08-23,Reversal,0.0,359.5,719.0
2020-08-23,Debit Card,0.0,102.71,616.29
2020-08-23,Bill,16011.0,0.0,16627.29
2020-08-23,Commission,0.0,3325.46,13301.83
2020-08-23,Cash,0.0,1477.98,11823.85
2020-08-23,Cheque,0.0,3941.28,7882.57
2020-08-23,Cash,3960.92,0.0,11843.49
2020-08-23,Transfer,0.0,2368.7,9474.79
2020-08-23,Cash,0.0,1353.54,8121.25
2020-08-23,NEFT,0.0,812.13,7309.12
2020-08-23,NEFT,0.0,1044.16,6264.96
2020-08-23,Cheque,0.0,1252.99,5011.97
2020-08-23,Miscellaneous,0.0,1002.39,4009.58
2020-08-23,Interest,1.0,0.0,4010.58
2020-08-23,Debit Card,8729.5,0.0,12740.08
2020-08-23,ATM,0.0,6370.04,6370.04
2020-08-23,Cheque,0.0,6370.04,0.0
2020-08-23,NEFT,54.77,0.0,54.77
2020-08-23,Bill,0.0,6.85,47.92
2020-08-23,ATM,0.0,23.96,23.96
2020-08-23,NEFT,252961.1,0.0,252985.06
2020-08-23,Reversal,0.0,50597.01,202388.05
2020-08-23,Cash,2795.1,0.0,205183.15
2020-08-23,Commission,0.0,102591.58,102591.58
2020-08-23,Debit Card,0.0,102591.58,0.0
2020-08-23,Bill,29662.05,0.0,29662.05
2020-08-23,Debit Card,0.0,3295.78,26366.27
2020-08-23,Purchase,55.0,0.0,26421.27
2020-08-23,RTGS,206667.8,0.0,233089.07
2020-08-23,Bill,1658310.0,0.0,1891399.07
2020-08-23,RTGS,2385.1,0.0,1893784.17
2020-08-23,Commission,0.0,631261.39,1262522.78
2020-08-23,Debit Card,6.4,0.0,1262529.18
2020-08-23,Debit Card,0.0,140281.02,1122248.16
2020-08-23,Commission,0.0,374082.72,748165.44
2020-08-23,Tax,0.0,249388.48,498776.96
2020-08-23,Purchase,4.0,0.0,498780.96
2020-08-23,RTGS,176.89,0.0,498957.85
2020-08-23,Interest,0.0,71279.69,427678.16
2020-08-23,Cash,0.0,47519.8,380158.36
2020-08-23,Miscellaneous,0.0,76031.67,304126.69
2020-08-23,Miscellaneous,0.0,43446.67,260680.02
2020-08-24,Tax,1086041.0,0.0,1346721.02
2020-08-24,Bill,497.06,0.0,1347218.08
2020-08-24,Transfer,0.0,134721.81,1212496.27
2020-08-24,Cheque,0.0,151562.03,1060934.24
2020-08-24,Transfer,1846.56,0.0,1062780.8
2020-08-24,Debit Card,631472.0,0.0,1694252.8
2020-08-24,Purchase,15629.0,0.0,1709881.8
2020-08-24,IMPS,174734.7,0.0,1884616.5
2020-08-24,Cheque,26.9,0.0,1884643.4
2020-08-24,Cash,274.7,0.0,1884918.1
2020-08-24,Purchase,15.2,0.0,1884933.3
2020-08-24,RTGS,0.0,188493.33,1696439.97
2020-08-24,ATM,0.0,565479.99,1130959.98
2020-08-24,Reversal,74038.72,0.0,1204998.7
2020-08-24,ATM,0.0,172142.67,1032856.03
2020-08-24,Miscellaneous,86627.0,0.0,1119483.03
2020-08-24,Tax,0.0,1119483.03,0.0
2020-08-25,RTGS,3364.1,0.0,3364.1
2020-08-25,Transfer,0.0,420.51,2943.59
2020-08-26,Interest,10699.78,0.0,13643.37
2020-08-26,Tax,0.0,1705.42,11937.95
2020-08-26,RTGS,0.0,1492.24,10445.71
2020-08-26,RTGS,0.0,1160.63,9285.08
2020-08-26,Purchase,0.0,1857.02,7428.06
2020-08-26,NEFT,0.0,1238.01,6190.05
2020-08-26,RTGS,0.0,1031.68,5158.38
2020-08-26,Purchase,1098.2,0.0,6256.58
2020-08-26,Cash,0.0,1251.32,5005.26
2020-08-26,Interest,46.2,0.0,5051.46
2020-08-26,NEFT,3871.6,0.0,8923.06
2020-08-26,Debit Card,0.0,1784.61,7138.45
2020-08-26,ATM,0.0,713.85,6424.6
2020-08-27,Transfer,329.6,0.0,6754.2
2020-08-27,NEFT,0.0,1125.7,5628.5
2020-08-27,Tax,32651.54,0.0,38280.04
2020-08-27,ATM,44.0,0.0,38324.04
2020-08-27,ATM,1.24,0.0,38325.28
2020-08-27,Commission,0.0,12775.09,25550.19
2020-08-27,IMPS,0.0,2838.91,22711.28
2020-08-27,NEFT,887.03,0.0,23598.31
2020-08-27,ATM,70759.0,0.0,94357.31
2020-08-27,Miscellaneous,0.0,10484.15,83873.16
2020-08-27,Miscellaneous,6.0,0.0,83879.16
2020-08-27,Miscellaneous,0.0,10484.9,73394.26
2020-08-27,Cheque,134526.0,0.0,207920.26
2020-08-27,Interest,232.0,0.0,208152.26
2020-08-27,NEFT,0.0,26019.03,182133.23
2020-08-27,IMPS,0.0,26019.03,156114.2
2020-08-27,RTGS,0.0,19514.28,136599.93
2020-08-27,Miscellaneous,0.0,15177.77,121422.16
2020-08-27,Cash,37.1,0.0,121459.26
2020-08-27,Transfer,51.9,0.0,121511.16
2020-08-27,Purchase,977896.0,0.0,1099407.16
2020-08-27,ATM,112202.47,0.0,1211609.63
2020-08-27,RTGS,5812.6,0.0,1217422.23
2020-08-27,ATM,0.0,608711.12,608711.12
2020-08-27,Interest,87.0,0.0,608798.12
2020-08-27,Miscellaneous,281350.8,0.0,890148.92
2020-08-27,Debit Card,0.0,445074.46,445074.46
2020-08-27,Tax,363356.0,0.0,808430.46
2020-08-27,Cheque,0.0,80843.05,727587.41
2020-08-27,Cash,0.0,181896.85,545690.56
2020-08-27,Commission,95879.9,0.0,641570.46
2020-08-27,Miscellaneous,18525.99,0.0,660096.45
2020-08-27,Transfer,3077.0,0.0,663173.45
2020-08-28,Tax,227.4,0.0,663400.85
2020-08-28,Purchase,0.0,165850.21,497550.64
2020-08-28,Interest,0.0,82925.11,414625.53
2020-08-28,Cash,0.6,0.0,414626.13
2020-08-28,Reversal,0.0,46069.57,368556.56
2020-08-28,NEFT,0.0,46069.57,322486.99
2020-08-28,Reversal,0.0,107495.66,214991.33
2020-08-28,Interest,0.0,53747.83,161243.5
2020-08-28,RTGS,0.0,17915.94,143327.56
2020-08-29,IMPS,0.0,71663.78,71663.78
2020-08-29,Debit Card,44.0,0.0,71707.78
2020-08-29,Bill,0.0,17926.95,53780.84
2020-08-29,NEFT,193.74,0.0,53974.58
2020-08-29,Debit Card,42941.4,0.0,96915.98
2020-08-29,Purchase,1491531.0,0.0,1588446.98
2020-08-29,Cash,3716.5,0.0,1592163.48
2020-08-29,Bill,0.0,176907.05,1415256.43
2020-08-29,RTGS,0.0,1415256.43,0.0
2020-08-29,Debit Card,223474.0,0.0,223474.0
2020-08-29,Commission,10931.0,0.0,234405.0
2020-08-29,Interest,0.0,234405.0,0.0
2020-08-29,Transfer,31.0,0.0,31.0
2020-08-29,Commission,0.0,4.43,26.57
2020-08-29,Transfer,1714731.0,0.0,1714757.57
2020-08-29,Interest,3091.56,0.0,1717849.13
2020-08-29,Transfer,20652.9,0.0,1738502.03
2020-08-29,Transfer,1635.0,0.0,1740137.03
2020-08-29,Purchase,0.0,1740137.03,0.0
2020-08-29,Purchase,503.59,0.0,503.59
2020-08-29,Bill,0.0,50.36,453.23
2020-08-29,Commission,0.0,151.08,302.15
2020-08-29,Purchase,0.0,50.36,251.79
2020-08-29,Interest,0.0,41.97,209.82
2020-08-29,RTGS,0.0,29.97,179.85
2020-08-29,Bill,0.0,17.99,161.86
2020-08-30,RTGS,0.0,26.98,134.88
2020-08-30,Cheque,0.0,19.27,115.61
2020-08-30,Cheque,0.0,57.81,57.8
2020-08-30,Interest,4.3,0.0,62.1
2020-08-30,Cash,9.0,0.0,71.1
2020-08-30,Commission,82053.3,0.0,82124.4
2020-08-30,RTGS,92237.06,0.0,174361.46
2020-08-30,Commission,877120.0,0.0,1051481.46
2020-08-30,Tax,202.0,0.0,1051683.46
2020-08-30,ATM,3312.0,0.0,1054995.46
2020-08-30,Bill,0.0,150713.64,904281.82
2020-08-30,NEFT,0.0,452140.91,452140.91
2020-08-30,ATM,0.0,226070.46,226070.46
2020-08-30,ATM,164.0,0.0,226234.46
2020-08-30,Reversal,258167.8,0.0,484402.26
2020-08-30,Reversal,0.0,48440.23,435962.03
2020-08-30,NEFT,618.8,0.0,436580.83
2020-08-30,Reversal,21.0,0.0,436601.83
2020-08-30,Interest,275.74,0.0,436877.57
2020-08-30,ATM,3574.5,0.0,440452.07
2020-08-31,Commission,17.0,0.0,440469.07
2020-08-31,Interest,0.0,220234.54,220234.54
2020-09-01,Transfer,6222.32,0.0,226456.86
2020-09-01,ATM,53.3,0.0,226510.16
2020-09-01,Reversal,0.0,28313.77,198196.39
2020-09-01,Cash,938633.75,0.0,1136830.14
2020-09-01,IMPS,1.4,0.0,1136831.54
2020-09-02,Purchase,2719.0,0.0,1139550.54
2020-09-02,NEFT,238647.1,0.0,1378197.64
2020-09-02,Debit Card,0.0,196885.38,1181312.26
2020-09-02,Debit Card,0.0,131256.92,1050055.34
2020-09-02,RTGS,1702770.2,0.0,2752825.54
2020-09-02,Cheque,0.0,550565.11,2202260.43
2020-09-02,ATM,1261327.8,0.0,3463588.23
2020-09-02,RTGS,1216645.5,0.0,4680233.73
2020-09-02,Interest,0.0,520025.97,4160207.76
2020-09-02,Transfer,0.0,462245.31,3697962.45
2020-09-02,Bill,0.0,410884.72,3287077.73
2020-09-02,Transfer,7.9,0.0,3287085.63
2020-09-02,Tax,377.55,0.0,3287463.18
2020-09-02,Miscellaneous,245.53,0.0,3287708.71
2020-09-02,ATM,0.0,657541.74,2630166.97
2020-09-02,NEFT,0.0,263016.7,2367150.27
2020-09-02,NEFT,51.1,0.0,2367201.37
2020-09-03,Bill,0.0,789067.12,1578134.25
2020-09-03,Purchase,0.0,789067.13,789067.12
2020-09-03,RTGS,1384.35,0.0,790451.47
2020-09-04,Transfer,0.0,98806.43,691645.04
2020-09-04,Interest,0.0,98806.43,592838.61
2020-09-04,NEFT,0.0,592838.61,0.0
2020-09-04,RTGS,0.72,0.0,0.72
2020-09-04,Transfer,3.33,0.0,4.05
2020-09-05,Reversal,0.0,1.35,2.7
2020-09-05,Bill,0.0,1.35,1.35
2020-09-05,Interest,0.0,0.23,1.12
2020-09-05,Reversal,922.0,0.0,923.12
2020-09-05,Commission,1858278.0,0.0,1859201.12
2020-09-05,Interest,277.0,0.0,1859478.12
2020-09-05,Interest,0.0,619826.04,1239652.08
2020-09-05,Transfer,340.9,0.0,1239992.98
2020-09-05,Transfer,1892.78,0.0,1241885.76
2020-09-05,Bill,0.0,248377.15,993508.61
2020-09-05,NEFT,0.0,198701.72,794806.89
2020-09-05,Cheque,0.0,88311.88,706495.01
2020-09-05,Transfer,9815.44,0.0,716310.45
2020-09-05,Cheque,723495.75,0.0,1439806.2
2020-09-05,ATM,0.0,143980.62,1295825.58
2020-09-06,Bill,6.5,0.0,1295832.08
2020-09-06,NEFT,347.0,0.0,1296179.08
2020-09-06,Tax,12657.4,0.0,1308836.48
2020-09-06,Interest,220259.06,0.0,1529095.54
2020-09-06,RTGS,0.0,382273.89,1146821.66
2020-09-06,NEFT,167.5,0.0,1146989.16
2020-09-06,Cheque,0.0,573494.58,573494.58
2020-09-06,Cheque,0.0,71686.82,501807.76
2020-09-06,IMPS,750867.2,0.0,1252674.96
2020-09-06,NEFT,59.8,0.0,1252734.76
2020-09-06,IMPS,4778.51,0.0,1257513.27
2020-09-06,Miscellaneous,0.0,1257513.27,0.0
2020-09-06,NEFT,25899.0,0.0,25899.0
2020-09-06,Commission,0.0,3699.86,22199.14
2020-09-06,Interest,0.0,0.0,22199.14
2020-09-06,Miscellaneous,0.0,2466.57,19732.57
2020-09-06,Cheque,0.0,19732.57,0.0
2020-09-06,Transfer,4.21,0.0,4.21
2020-09-06,Cheque,0.0,1.05,3.16
2020-09-06,Debit Card,0.0,0.53,2.63
2020-09-06,Miscellaneous,0.0,0.66,1.97
2020-09-06,Debit Card,0.0,0.99,0.98
2020-09-06,IMPS,0.0,0.98,0.0
2020-09-06,Bill,213.6,0.0,213.6
2020-09-06,Reversal,2033119.2,0.0,2033332.8
2020-09-06,Cash,260909.12,0.0,2294241.92
2020-09-06,Reversal,0.0,286780.24,2007461.68
2020-09-06,Interest,0.0,401492.34,1605969.34
2020-09-06,ATM,23090.54,0.0,1629059.88
2020-09-06,Transfer,778.81,0.0,1629838.69
2020-09-06,IMPS,0.0,232834.1,1397004.59
2020-09-07,Cheque,442.45,0.0,1397447.04
2020-09-07,Transfer,1251.0,0.0,1398698.04
2020-09-07,Reversal,8.7,0.0,1398706.74
2020-09-07,Commission,0.0,233117.79,1165588.95
2020-09-07,Cash,0.0,166512.71,999076.24
2020-09-07,Miscellaneous,32705.0,0.0,1031781.24
2020-09-07,IMPS,0.0,147397.32,884383.92
2020-09-07,Purchase,0.0,126340.56,758043.36
2020-09-07,Bill,7.7,0.0,758051.06
2020-09-07,ATM,2432.0,0.0,760483.06
2020-09-07,Cheque,4052.17,0.0,764535.23
2020-09-07,IMPS,0.0,76453.52,688081.71
2020-09-07,Transfer,39.5,0.0,688121.21
2020-09-07,Cash,1513966.0,0.0,2202087.21
2020-09-07,IMPS,412.0,0.0,2202499.21
2020-09-07,Transfer,0.0,244722.13,1957777.08
2020-09-07,Reversal,5.0,0.0,1957782.08
2020-09-07,Cheque,0.0,326297.01,1631485.07
2020-09-07,Reversal,1782155.0,0.0,3413640.07
2020-09-07,Transfer,156911.84,0.0,3570551.91
2020-09-07,Commission,0.0,357055.19,3213496.72
2020-09-07,Cheque,0.0,357055.19,2856441.53
2020-09-07,Bill,0.0,952147.18,1904294.35
2020-09-07,Reversal,2534.91,0.0,1906829.26
2020-09-07,Purchase,69855.0,0.0,1976684.26
2020-09-07,Reversal,166.34,0.0,1976850.6
2020-09-07,NEFT,8517.02,0.0,1985367.62
2020-09-07,Interest,2.0,0.0,1985369.62
2020-09-07,ATM,3.0,0.0,1985372.62
2020-09-07,Purchase,125.08,0.0,1985497.7
2020-09-07,Interest,10590.0,0.0,1996087.7
2020-09-07,Interest,596055.8,0.0,2592143.5
2020-09-07,Interest,396941.5,0.0,2989085.0
2020-09-07,Commission,21.0,0.0,2989106.0
2020-09-07,Tax,3310.9,0.0,2992416.9
2020-09-07,Tax,0.8,0.0,2992417.7
2020-09-07,Commission,98.24,0.0,2992515.94
2020-09-07,Reversal,5.5,0.0,2992521.44
2020-09-07,Reversal,10164.0,0.0,3002685.44
2020-09-07,Cash,0.0,500447.57,2502237.87
2020-09-07,Interest,382115.5,0.0,2884353.37
2020-09-07,Purchase,0.0,961451.12,1922902.25
2020-09-07,Interest,0.0,961451.13,961451.12
2020-09-08,NEFT,1499.0,0.0,962950.12
2020-09-08,Purchase,325.0,0.0,963275.12
2020-09-08,ATM,766598.2,0.0,1729873.32
2020-09-08,Cheque,241951.0,0.0,1971824.32
2020-09-08,Commission,29.0,0.0,1971853.32
2020-09-08,Transfer,59175.2,0.0,2031028.52
2020-09-08,Reversal,0.0,253878.57,1777149.96
2020-09-08,NEFT,0.0,177715.0,1599434.96
2020-09-08,Cheque,0.0,228490.71,1370944.25
2020-09-08,Bill,0.0,342736.06,1028208.19
2020-09-08,Miscellaneous,1360620.25,0.0,2388828.44
2020-09-08,Miscellaneous,1.0,0.0,2388829.44
2020-09-08,ATM,26845.22,0.0,2415674.66
2020-09-08,RTGS,281.8,0.0,2415956.46
2020-09-08,Commission,0.0,483191.29,1932765.17
2020-09-08,IMPS,24.55,0.0,1932789.72
2020-09-08,Miscellaneous,6.2,0.0,1932795.92
2020-09-08,Cash,1.0,0.0,1932796.92
2020-09-08,Miscellaneous,0.0,966398.46,966398.46
2020-09-08,Debit Card,0.0,96639.85,869758.61
2020-09-08,Debit Card,4014.0,0.0,873772.61
2020-09-08,Cheque,41.0,0.0,873813.61
2020-09-08,Interest,0.0,109226.7,764586.91
2020-09-08,Cash,0.5,0.0,764587.41
2020-09-09,Debit Card,3398.0,0.0,767985.41
2020-09-09,Bill,98.0,0.0,768083.41
2020-09-09,Miscellaneous,0.0,85342.6,682740.81
2020-09-09,Tax,0.0,68274.08,614466.73
2020-09-09,IMPS,0.0,76808.34,537658.39
2020-09-09,Debit Card,7032.0,0.0,544690.39
2020-09-09,ATM,200667.0,0.0,745357.39
2020-09-09,Transfer,0.0,372678.7,372678.7
2020-09-09,Miscellaneous,0.0,186339.35,186339.35
2020-09-09,Debit Card,1688438.5,0.0,1874777.85
2020-09-09,IMPS,0.0,234347.23,1640430.62
2020-09-09,Interest,194362.0,0.0,1834792.62
2020-09-09,Reversal,0.0,366958.52,1467834.1
2020-09-09,ATM,2.0,0.0,1467836.1
2020-09-09,Cheque,119.6,0.0,1467955.7
2020-09-09,Miscellaneous,0.0,209707.96,1258247.74
2020-09-09,Transfer,121.48,0.0,1258369.22
2020-09-10,ATM,0.0,179767.03,1078602.19
2020-09-10,RTGS,191.0,0.0,1078793.19
2020-09-11,Reversal,0.0,359597.73,719195.46
2020-09-11,Transfer,452610.0,0.0,1171805.46
2020-09-12,Cheque,4916.9,0.0,1176722.36
2020-09-12,Cash,0.0,588361.18,588361.18
2020-09-12,Cash,0.0,58836.12,529525.06
2020-09-12,NEFT,260382.6,0.0,789907.66
2020-09-12,Debit Card,221.0,0.0,790128.66
2020-09-12,Transfer,545386.2,0.0,1335514.86
2020-09-12,Interest,0.0,190787.84,1144727.02
2020-09-12,Debit Card,0.0,228945.4,915781.62
2020-09-12,Interest,0.0,91578.16,824203.46
2020-09-12,RTGS,0.0,274734.49,549468.97
2020-09-12,Interest,781.0,0.0,550249.97
2020-09-12,Commission,1910.0,0.0,552159.97
2020-09-12,Tax,0.0,110431.99,441727.98
2020-09-12,Transfer,3.0,0.0,441730.98
2020-09-12,Cash,22.0,0.0,441752.98
2020-09-12,ATM,0.0,44175.3,397577.68
2020-09-12,Purchase,413.0,0.0,397990.68
2020-09-12,Reversal,0.0,44221.19,353769.49
2020-09-12,Purchase,406.2,0.0,354175.69
2020-09-12,Transfer,2056960.75,0.0,2411136.44
2020-09-12,Tax,0.0,267904.05,2143232.39
2020-09-12,Bill,45.7,0.0,2143278.09
2020-09-12,Cheque,41.33,0.0,2143319.42
2020-09-12,Cheque,0.0,306188.49,1837130.93
2020-09-12,Cheque,0.0,306188.49,1530942.44
2020-09-12,Purchase,7.0,0.0,1530949.44
2020-09-12,Tax,299.7,0.0,1531249.14
2020-09-12,Bill,7.09,0.0,1531256.23
2020-09-12,IMPS,14902.6,0.0,1546158.83
2020-09-13,NEFT,0.0,171795.43,1374363.4
2020-09-13,ATM,4.5,0.0,1374367.9
2020-09-13,Transfer,2904.55,0.0,1377272.45
2020-09-13,Transfer,884479.5,0.0,2261751.95
2020-09-13,IMPS,0.0,753917.32,1507834.63
2020-09-13,ATM,0.0,150783.46,1357051.17
2020-09-13,IMPS,5.44,0.0,1357056.61
2020-09-13,Debit Card,0.0,135705.66,1221350.95
2020-09-13,Tax,0.0,407116.98,814233.97
2020-09-13,RTGS,88.38,0.0,814322.35
2020-09-13,Bill,0.0,135720.39,678601.96
2020-09-13,Purchase,0.0,75400.22,603201.74
2020-09-13,Commission,0.0,301600.87,301600.87
2020-09-13,Purchase,336.81,0.0,301937.68
2020-09-13,RTGS,1602771.0,0.0,1904708.68
2020-09-14,Bill,37.63,0.0,1904746.31
2020-09-14,Interest,0.0,211638.48,1693107.83
2020-09-14,Miscellaneous,534922.0,0.0,2228029.83
2020-09-14,Bill,2008229.8,0.0,4236259.63
2020-09-14,Commission,2900.0,0.0,4239159.63
2020-09-15,Cash,0.0,1059789.91,3179369.72
2020-09-15,ATM,0.0,397421.22,2781948.51
2020-09-15,IMPS,0.0,397421.22,2384527.29
2020-09-15,Commission,0.0,340646.76,2043880.53
2020-09-15,Commission,0.0,204388.05,1839492.48
2020-09-15,Reversal,245.0,0.0,1839737.48
2020-09-15,Transfer,0.0,204415.28,1635322.2
2020-09-15,Cash,1751873.5,0.0,3387195.7
2020-09-15,Miscellaneous,0.0,846798.93,2540396.78
2020-09-15,Debit Card,0.0,423399.46,2116997.32
2020-09-15,Bill,0.0,2116997.32,0.0
2020-09-15,Reversal,2662.99,0.0,2662.99
2020-09-15,Debit Card,0.0,380.43,2282.56
2020-09-15,Bill,199807.0,0.0,202089.56
2020-09-15,Cheque,170.0,0.0,202259.56
2020-09-15,ATM,16689.37,0.0,218948.93
2020-09-15,Purchase,16.91,0.0,218965.84
2020-09-15,RTGS,0.0,31280.83,187685.01
2020-09-15,Cheque,2422.57,0.0,190107.58
2020-09-15,Debit Card,0.0,31684.6,158422.98
2020-09-15,Purchase,0.0,17602.55,140820.43
2020-09-15,Transfer,8939.69,0.0,149760.12
2020-09-15,NEFT,254614.97,0.0,404375.09
2020-09-15,Debit Card,0.0,134791.7,269583.39
2020-09-15,RTGS,0.0,67395.85,202187.54
2020-09-15,Cash,0.0,25273.44,176914.1
2020-09-15,Miscellaneous,0.0,35382.82,141531.28
2020-09-15,IMPS,0.0,28306.26,113225.02
2020-09-15,Miscellaneous,18.93,0.0,113243.95
2020-09-15,Transfer,27.0,0.0,113270.95
2020-09-15,Cash,218.61,0.0,113489.56
2020-09-15,Bill,5.0,0.0,113494.56
2020-09-15,Cash,0.0,56747.28,56747.28
2020-09-15,Interest,0.0,6305.25,50442.03
2020-09-15,Bill,2076465.0,0.0,2126907.03
2020-09-15,IMPS,3019.2,0.0,2129926.23
2020-09-15,Purchase,74.0,0.0,2130000.23
2020-09-15,Commission,57.0,0.0,2130057.23
2020-09-15,Purchase,1360195.8,0.0,3490253.03
2020-09-15,Transfer,0.0,387805.89,3102447.14
2020-09-15,Cheque,13799.14,0.0,3116246.28
2020-09-15,ATM,794307.0,0.0,3910553.28
2020-09-15,Interest,0.0,488819.16,3421734.12
2020-09-15,Cash,479.4,0.0,3422213.52
2020-09-15,Commission,0.0,427776.69,2994436.83
2020-09-15,Miscellaneous,0.0,499072.81,2495364.02
2020-09-15,Commission,0.0,277262.67,2218101.35
2020-09-15,NEFT,0.0,2218101.35,0.0
2020-09-15,Bill,1.03,0.0,1.03
2020-09-15,Reversal,1687673.0,0.0,1687674.03
2020-09-15,Debit Card,0.0,337534.81,1350139.22
2020-09-15,Reversal,0.0,135013.92,1215125.3
2020-09-15,Cash,0.0,135013.92,1080111.38
2020-09-15,Cheque,22879.0,0.0,1102990.38
2020-09-15,Reversal,0.0,220598.08,882392.3
2020-09-15,Cash,0.0,126056.04,756336.26
2020-09-15,NEFT,0.0,126056.04,630280.22
2020-09-15,NEFT,0.0,63028.02,567252.2
2020-09-15,Miscellaneous,0.0,141813.05,425439.15
2020-09-15,RTGS,0.0,47271.02,378168.13
2020-09-15,IMPS,0.0,126056.04,252112.09
2020-09-15,NEFT,161255.2,0.0,413367.29
2020-09-15,IMPS,39643.0,0.0,453010.29
2020-09-15,Tax,1801.68,0.0,454811.97
2020-09-15,Tax,0.0,151603.99,303207.98
2020-09-15,Commission,6.0,0.0,303213.98
2020-09-15,Bill,329.1,0.0,303543.08
2020-09-15,Transfer,0.0,303543.08,0.0
2020-09-15,Interest,37039.8,0.0,37039.8
2020-09-15,Tax,0.0,37039.8,0.0
2020-09-15,IMPS,243467.5,0.0,243467.5
2020-09-15,Bill,825841.5,0.0,1069309.0
2020-09-15,Tax,0.0,118812.11,950496.89
2020-09-15,RTGS,23474.4,0.0,973971.29
2020-09-15,Interest,486.0,0.0,974457.29
2020-09-15,Commission,132780.5,0.0,1107237.79
2020-09-15,Cheque,54.0,0.0,1107291.79
2020-09-15,Reversal,421.0,0.0,1107712.79
2020-09-15,Cheque,7.75,0.0,1107720.54
2020-09-15,Transfer,47.2,0.0,1107767.74
2020-09-15,IMPS,0.0,184627.96,923139.78
2020-09-15,IMPS,1.66,0.0,923141.44
2020-09-15,ATM,43.0,0.0,923184.44
2020-09-15,Debit Card,6.6,0.0,923191.04
2020-09-15,Cheque,9881.0,0.0,933072.04
2020-09-15,RTGS,0.0,466536.02,466536.02
2020-09-15,Cheque,2945.5,0.0,469481.52
2020-09-15,Transfer,0.0,46948.15,422533.37
2020-09-15,Miscellaneous,0.0,84506.67,338026.7
2020-09-15,Interest,0.0,338026.7,0.0
2020-09-15,ATM,510.6,0.0,510.6
2020-09-15,Commission,0.0,102.12,408.48
2020-09-15,Tax,0.0,68.08,340.4
2020-09-15,Purchase,288.88,0.0,629.28
2020-09-15,Debit Card,0.0,69.92,559.36
2020-09-15,Interest,1615027.5,0.0,1615586.86
2020-09-15,Cheque,0.0,807793.43,807793.43
2020-09-15,NEFT,23.0,0.0,807816.43
2020-09-15,Cheque,201.71,0.0,808018.14
2020-09-15,Bill,54630.0,0.0,862648.14
2020-09-15,Cheque,2695.04,0.0,865343.18
2020-09-15,NEFT,38.0,0.0,865381.18
2020-09-15,ATM,205.0,0.0,865586.18
2020-09-15,Miscellaneous,0.0,432793.09,432793.09
2020-09-15,Purchase,3.6,0.0,432796.69
2020-09-15,Commission,0.0,108199.17,324597.52
2020-09-15,Cash,0.0,64919.5,259678.02
2020-09-15,Interest,1638148.5,0.0,1897826.52
2020-09-15,Tax,313.7,0.0,1898140.22
2020-09-15,Debit Card,0.0,949070.11,949070.11
2020-09-15,Bill,0.0,189814.02,759256.09
2020-09-15,ATM,12433.0,0.0,771689.09
2020-09-16,RTGS,549535.0,0.0,1321224.09
2020-09-16,RTGS,0.0,220204.02,1101020.08
2020-09-16,ATM,1.0,0.0,1101021.08
2020-09-16,Tax,0.0,1101021.08,0.0
2020-09-16,ATM,6.14,0.0,6.14
2020-09-16,Miscellaneous,2148.7,0.0,2154.84
2020-09-16,Commission,0.0,359.14,1795.7
2020-09-16,Tax,0.0,199.52,1596.18
2020-09-16,Debit Card,29131.08,0.0,30727.26
2020-09-16,Bill,452.27,0.0,31179.53
2020-09-16,RTGS,36.29,0.0,31215.82
2020-09-16,Cheque,254534.06,0.0,285749.88
2020-09-16,Tax,509.2,0.0,286259.08
2020-09-16,Bill,0.0,286259.08,0.0
2020-09-16,Purchase,23.0,0.0,23.0
2020-09-16,Tax,0.0,4.6,18.4
2020-09-16,Debit Card,27637.7,0.0,27656.1
2020-09-16,Commission,550677.0,0.0,578333.1
2020-09-16,Interest,0.0,57833.31,520499.79
2020-09-16,Commission,1606.0,0.0,522105.79
2020-09-16,ATM,0.0,104421.16,417684.63
2020-09-16,NEFT,11675.5,0.0,429360.13
2020-09-16,Reversal,0.0,47706.68,381653.45
2020-09-16,Tax,1972385.5,0.0,2354038.95
2020-09-16,IMPS,1860241.25,0.0,4214280.2
2020-09-16,Miscellaneous,12.02,0.0,4214292.22
2020-09-16,RTGS,0.0,4214292.22,0.0
2020-09-16,Cheque,53.75,0.0,53.75
2020-09-16,IMPS,218786.5,0.0,218840.25
2020-09-16,Bill,0.0,43768.05,175072.2
2020-09-17,Cheque,0.0,87536.1,87536.1
2020-09-17,Purchase,0.0,10942.01,76594.09
2020-09-17,Interest,16.0,0.0,76610.09
2020-09-17,Cheque,0.0,9576.26,67033.83
2020-09-17,Interest,30.2,0.0,67064.03
2020-09-17,NEFT,0.0,33532.02,33532.02
2020-09-17,Bill,0.0,4191.5,29340.52
2020-09-17,ATM,0.0,5868.1,23472.42
2020-09-17,Bill,0.0,2934.05,20538.37
2020-09-17,NEFT,0.0,10269.19,10269.18
2020-09-17,Interest,0.0,1711.53,8557.65
2020-09-17,Bill,29382.9,0.0,37940.55
2020-09-17,Purchase,0.0,7588.11,30352.44
2020-09-17,Cheque,0.0,10117.48,20234.96
2020-09-17,Debit Card,0.0,6744.99,13489.97
2020-09-18,Cheque,1573826.0,0.0,1587315.97
2020-09-18,NEFT,92612.0,0.0,1679927.97
2020-09-18,Debit Card,7.0,0.0,1679934.97
2020-09-18,Commission,1929475.25,0.0,3609410.22
2020-09-18,Debit Card,0.0,1203136.74,2406273.48
2020-09-18,IMPS,788.0,0.0,2407061.48
2020-09-18,Cash,2.34,0.0,2407063.82
2020-09-18,Cheque,8285.1,0.0,2415348.92
2020-09-18,RTGS,0.0,2415348.92,0.0
2020-09-18,Cheque,59.1,0.0,59.1
2020-09-18,Interest,15055.9,0.0,15115.0
2020-09-18,Reversal,480.0,0.0,15595.0
2020-09-18,Purchase,0.0,3119.0,12476.0
2020-09-18,Interest,0.0,3119.0,9357.0
2020-09-18,Cash,4051.85,0.0,13408.85
2020-09-18,Commission,554924.2,0.0,568333.05
2020-09-18,Reversal,164.0,0.0,568497.05
2020-09-18,NEFT,2648.0,0.0,571145.05
2020-09-18,Commission,0.0,114229.01,456916.04
2020-09-18,Miscellaneous,0.0,65273.72,391642.32
2020-09-18,Reversal,19.6,0.0,391661.92
2020-09-18,Bill,48.0,0.0,391709.92
2020-09-18,Bill,0.0,195854.96,195854.96
2020-09-18,Cheque,58.0,0.0,195912.96
2020-09-18,Transfer,1366820.0,0.0,1562732.96
2020-09-18,Cash,0.0,156273.3,1406459.66
2020-09-18,Cash,159509.0,0.0,1565968.66
2020-09-18,Cash,11.36,0.0,1565980.02
2020-09-18,Purchase,0.0,260996.67,1304983.35
2020-09-18,Debit Card,3.5,0.0,1304986.85
2020-09-18,RTGS,250972.0,0.0,1555958.85
2020-09-18,Commission,0.0,1555958.85,0.0
2020-09-18,Reversal,249.7,0.0,249.7
2020-09-18,ATM,305.7,0.0,555.4
2020-09-18,Reversal,2532.37,0.0,3087.77
2020-09-18,Commission,710.3,0.0,3798.07
2020-09-18,Debit Card,304837.0,0.0,308635.07
2020-09-18,Tax,1550760.8,0.0,1859395.87
2020-09-18,Debit Card,0.0,265627.98,1593767.89
2020-09-18,ATM,0.0,177085.32,1416682.57
2020-09-18,Bill,254.0,0.0,1416936.57
2020-09-19,Bill,3.79,0.0,1416940.36
2020-09-19,Interest,0.0,283388.07,1133552.29
2020-09-19,Reversal,738753.2,0.0,1872305.49
2020-09-19,RTGS,0.0,312050.92,1560254.58
2020-09-19,Commission,0.0,520084.86,1040169.72
2020-09-19,Bill,0.0,104016.97,936152.75
2020-09-19,Commission,0.0,133736.11,802416.64
2020-09-19,Commission,0.0,133736.11,668680.53
2020-09-19,Transfer,1675457.75,0.0,2344138.28
2020-09-19,Interest,0.0,468827.66,1875310.62
2020-09-19,Reversal,0.0,234413.83,1640896.79
2020-09-19,Tax,69.5,0.0,1640966.29
2020-09-19,Purchase,6.0,0.0,1640972.29
2020-09-19,Cash,0.0,234424.61,1406547.68
2020-09-19,ATM,73.4,0.0,1406621.08
2020-09-19,Debit Card,31231.9,0.0,1437852.98
2020-09-19,Reversal,0.0,1437852.98,0.0
2020-09-19,Miscellaneous,3704.0,0.0,3704.0
2020-09-19,Miscellaneous,0.0,617.33,3086.67
2020-09-19,Debit Card,3385.0,0.0,6471.67
2020-09-19,Miscellaneous,0.0,1617.92,4853.75
2020-09-19,Debit Card,0.0,539.31,4314.44
2020-09-19,Cash,0.0,2157.22,2157.22
2020-09-19,Bill,258862.0,0.0,261019.22
2020-09-19,Miscellaneous,0.0,29002.14,232017.08
2020-09-19,Tax,22504.3,0.0,254521.38
2020-09-19,Interest,0.0,63630.35,190891.04
2020-09-19,Cash,0.0,27270.15,163620.89
2020-09-19,Cash,3.08,0.0,163623.97
2020-09-19,Interest,0.0,16362.4,147261.57
2020-09-19,Purchase,0.0,14726.16,132535.41
2020-09-19,RTGS,3.0,0.0,132538.41
2020-09-19,ATM,0.0,44179.47,88358.94
2020-09-19,RTGS,378.0,0.0,88736.94
2020-09-19,Debit Card,3610.0,0.0,92346.94
2020-09-19,Cash,0.0,10260.77,82086.17
2020-09-19,Bill,838790.8,0.0,920876.97
2020-09-19,Cash,0.0,153479.5,767397.48
2020-09-19,Debit Card,0.0,95924.69,671472.8
2020-09-19,Debit Card,255.47,0.0,671728.27
2020-09-19,Miscellaneous,86843.2,0.0,758571.47
2020-09-19,Cheque,18.58,0.0,758590.05
2020-09-19,Debit Card,77.1,0.0,758667.15
2020-09-19,ATM,0.0,75866.72,682800.44
2020-09-19,IMPS,0.0,227600.15,455200.29
2020-09-19,RTGS,0.0,91040.06,364160.23
2020-09-19,Reversal,0.0,121386.74,242773.49
2020-09-19,IMPS,20890.5,0.0,263663.99
2020-09-19,Interest,2633.2,0.0,266297.19
2020-09-19,Bill,0.0,29588.58,236708.61
2020-09-19,Cheque,0.0,47341.72,189366.89
2020-09-19,Debit Card,6.5,0.0,189373.39
2020-09-19,Commission,31062.3,0.0,220435.69
2020-09-19,Interest,6.5,0.0,220442.19
2020-09-19,Tax,0.0,44088.44,176353.75
2020-09-19,Debit Card,0.0,176353.75,0.0
2020-09-19,NEFT,6.8,0.0,6.8
2020-09-19,NEFT,33.0,0.0,39.8
2020-09-19,Purchase,0.0,13.27,26.53
2020-09-19,Commission,29.05,0.0,55.58
2020-09-19,Cash,0.0,6.18,49.4
2020-09-19,Transfer,0.0,4.94,44.46
2020-09-19,Interest,153.07,0.0,197.53
2020-09-19,Tax,3.49,0.0,201.02
2020-09-19,Bill,460.68,0.0,661.7
2020-09-19,Tax,0.0,66.17,595.53
2020-09-19,IMPS,8995.77,0.0,9591.3
2020-09-19,Debit Card,5407.0,0.0,14998.3
2020-09-19,Interest,2452.3,0.0,17450.6
2020-09-19,RTGS,1976.4,0.0,19427.0
2020-09-19,Purchase,0.0,4856.75,14570.25
2020-09-19,Purchase,2.0,0.0,14572.25
2020-09-19,Miscellaneous,0.0,1457.23,13115.02
2020-09-19,Bill,437.4,0.0,13552.42
2020-09-19,Purchase,0.0,1936.06,11616.36
2020-09-19,Debit Card,0.0,2323.27,9293.09
2020-09-19,Tax,1949156.75,0.0,1958449.84
2020-09-19,Bill,0.0,652816.61,1305633.23
2020-09-20,Commission,0.0,1305633.23,0.0
2020-09-20,IMPS,50.01,0.0,50.01
2020-09-20,Commission,0.0,8.34,41.68
2020-09-20,Cheque,235181.5,0.0,235223.18
2020-09-20,Purchase,138839.7,0.0,374062.88
2020-09-20,NEFT,886.79,0.0,374949.67
2020-09-20,RTGS,1983915.0,0.0,2358864.67
2020-09-21,Transfer,903144.5,0.0,3262009.17
2020-09-21,Cash,31.0,0.0,3262040.17
2020-09-21,Debit Card,577314.0,0.0,3839354.17
2020-09-21,Transfer,0.0,959838.54,2879515.63
2020-09-21,Cash,257.3,0.0,2879772.93
2020-09-21,Commission,32.0,0.0,2879804.93
2020-09-21,Transfer,0.0,719951.23,2159853.7
2020-09-21,IMPS,8.0,0.0,2159861.7
2020-09-21,Tax,0.0,539965.43,1619896.28
2020-09-21,Bill,0.0,231413.75,1388482.53
2020-09-21,Debit Card,29.27,0.0,1388511.8
2020-09-21,RTGS,0.0,462837.27,925674.53
2020-09-21,Debit Card,0.0,925674.53,0.0
2020-09-21,NEFT,144.0,0.0,144.0
2020-09-21,IMPS,10166.05,0.0,10310.05
2020-09-21,Transfer,0.0,1718.34,8591.71
2020-09-21,Tax,0.0,1718.34,6873.37
2020-09-21,Commission,0.0,6873.37,0.0
2020-09-21,Commission,515470.0,0.0,515470.0
2020-09-21,Bill,0.0,85911.67,429558.33
2020-09-21,Transfer,0.0,47728.7,381829.63
2020-09-21,Miscellaneous,0.0,38182.96,343646.67
2020-09-21,IMPS,4.09,0.0,343650.76
2020-09-21,Cash,0.0,49092.97,294557.79
2020-09-21,RTGS,55.43,0.0,294613.22
2020-09-21,Interest,65694.28,0.0,360307.5
2020-09-21,Miscellaneous,0.0,40034.17,320273.33
2020-09-21,Commission,0.0,53378.89,266894.44
2020-09-21,Debit Card,0.0,44482.41,222412.03
2020-09-21,Debit Card,0.0,31773.15,190638.88
2020-09-21,NEFT,3235.72,0.0,193874.6
2020-09-21,Bill,0.0,96937.3,96937.3
2020-09-21,Interest,17041.0,0.0,113978.3
2020-09-21,IMPS,0.0,56989.15,56989.15
2020-09-21,Cash,0.0,9498.19,47490.96
2020-09-21,Commission,0.0,23745.48,23745.48
2020-09-21,Commission,384.0,0.0,24129.48
2020-09-21,Cash,0.0,2412.95,21716.53
2020-09-21,Reversal,0.0,10858.27,10858.26
2020-09-21,Transfer,13576.1,0.0,24434.36
2020-09-21,Cash,3328.0,0.0,27762.36
2020-09-21,Commission,54.3,0.0,27816.66
2020-09-21,Purchase,373744.0,0.0,401560.66
2020-09-21,Interest,0.0,401560.66,0.0
2020-09-21,Purchase,133782.0,0.0,133782.0
2020-09-21,Tax,0.0,19111.71,114670.29
2020-09-21,Reversal,0.0,11467.03,103203.26
2020-09-21,ATM,0.0,51601.63,51601.63
2020-09-21,Tax,0.0,12900.41,38701.22
2020-09-21,Bill,3214.0,0.0,41915.22
2020-09-21,Interest,1198182.0,0.0,1240097.22
2020-09-21,Interest,362.0,0.0,1240459.22
2020-09-21,Debit Card,76232.0,0.0,1316691.22
2020-09-21,Miscellaneous,47.06,0.0,1316738.28
2020-09-21,RTGS,0.0,164592.29,1152146.0
2020-09-21,ATM,67.0,0.0,1152213.0
2020-09-21,Reversal,0.0,115221.3,1036991.7
2020-09-21,Cash,0.0,172831.95,864159.75
2020-09-21,Commission,0.0,86415.98,777743.78
2020-09-21,RTGS,106356.97,0.0,884100.75
2020-09-21,Bill,211883.7,0.0,1095984.45
2020-09-22,Purchase,0.0,219196.89,876787.56
2020-09-22,Transfer,0.0,292262.52,584525.04
2020-09-23,Transfer,0.0,292262.52,292262.52
2020-09-23,Tax,6.6,0.0,292269.12
2020-09-23,ATM,0.0,146134.56,146134.56
2020-09-23,Tax,0.0,20876.37,125258.19
2020-09-23,Purchase,0.0,13917.58,111340.61
2020-09-23,NEFT,0.0,18556.77,92783.84
2020-09-23,Cheque,11194.3,0.0,103978.14
2020-09-23,Transfer,0.0,17329.69,86648.45
2020-09-23,Cheque,250244.09,0.0,336892.54
2020-09-23,Cheque,0.0,112297.51,224595.03
2020-09-23,Debit Card,1110742.0,0.0,1335337.03
2020-09-23,Purchase,178.8,0.0,1335515.83
2020-09-23,Transfer,0.0,667757.92,667757.92
2020-09-23,Tax,0.0,222585.97,445171.95
2020-09-23,IMPS,9.0,0.0,445180.95
2020-09-23,RTGS,0.0,44518.1,400662.86
2020-09-23,Cheque,0.0,40066.29,360596.57
2020-09-23,ATM,51.0,0.0,360647.57
2020-09-23,Interest,13.6,0.0,360661.17
2020-09-23,Transfer,0.0,360661.17,0.0
2020-09-23,ATM,544314.0,0.0,544314.0
2020-09-23,Tax,323359.5,0.0,867673.5
2020-09-23,IMPS,443.96,0.0,868117.46
2020-09-23,IMPS,0.0,868117.46,0.0
2020-09-23,Commission,28545.0,0.0,28545.0
2020-09-23,RTGS,0.0,7136.25,21408.75
2020-09-23,Bill,0.0,2676.09,18732.66
2020-09-23,Interest,0.0,2081.41,16651.25
2020-09-23,Purchase,0.0,2081.41,14569.84
2020-09-23,Debit Card,0.0,1821.23,12748.61
2020-09-23,Purchase,0.0,1593.58,11155.03
2020-09-23,Cheque,1818.0,0.0,12973.03
2020-09-23,RTGS,58.0,0.0,13031.03
2020-09-23,Bill,3156.0,0.0,16187.03
2020-09-23,Interest,0.0,8093.52,8093.52
2020-09-23,Tax,725.8,0.0,8819.32
2020-09-23,Commission,13511.1,0.0,22330.42
2020-09-23,Purchase,22051.18,0.0,44381.6
2020-09-23,RTGS,0.0,8876.32,35505.28
2020-09-23,NEFT,22.3,0.0,35527.58
2020-09-23,Cash,0.0,8881.9,26645.68
2020-09-23,Cash,0.0,8881.89,17763.79
2020-09-23,IMPS,0.0,3552.76,14211.03
2020-09-23,Cheque,0.0,1776.38,12434.65
2020-09-23,Cheque,0.0,0.0,12434.65
2020-09-24,IMPS,2668.2,0.0,15102.85
2020-09-24,Miscellaneous,128490.0,0.0,143592.85
2020-09-24,Commission,2529.4,0.0,146122.25
2020-09-24,IMPS,0.0,18265.28,127856.97
2020-09-24,Debit Card,0.0,21309.5,106547.48
2020-09-24,Reversal,207316.0,0.0,313863.48
2020-09-24,Cash,0.0,78465.87,235397.61
2020-09-24,Bill,246762.22,0.0,482159.83
2020-09-24,IMPS,0.0,48215.98,433943.85
2020-09-24,Miscellaneous,0.4,0.0,433944.25
2020-09-24,Tax,0.0,43394.43,390549.82
2020-09-24,Transfer,253128.6,0.0,643678.42
2020-09-24,Debit Card,26425.8,0.0,670104.22
2020-09-24,Cheque,174935.0,0.0,845039.22
2020-09-24,RTGS,89250.0,0.0,934289.22
2020-09-24,Commission,32.1,0.0,934321.32
2020-09-24,Bill,64.0,0.0,934385.32
2020-09-24,Miscellaneous,0.0,233596.33,700788.99
2020-09-24,IMPS,0.0,700788.99,0.0
2020-09-24,Tax,12993.0,0.0,12993.0
2020-09-24,Debit Card,0.0,12993.0,0.0
2020-09-24,Interest,153120.2,0.0,153120.2
2020-09-24,Debit Card,0.0,153120.2,0.0
2020-09-24,Purchase,14427.46,0.0,14427.46
2020-09-24,IMPS,0.0,1603.05,12824.41
2020-09-24,Cash,1879491.2,0.0,1892315.61
2020-09-24,Cash,0.0,630771.87,1261543.74
2020-09-24,Tax,694353.0,0.0,1955896.74
2020-09-24,Cheque,200275.81,0.0,2156172.55
2020-09-24,ATM,949254.25,0.0,3105426.8
2020-09-24,Interest,0.0,3105426.8,0.0
2020-09-24,Interest,185548.5,0.0,185548.5
2020-09-24,ATM,2071.36,0.0,187619.86
2020-09-24,ATM,0.0,37523.97,150095.89
2020-09-25,Bill,0.0,16677.32,133418.57
2020-09-25,Tax,0.0,33354.64,100063.93
2020-09-25,Cheque,0.0,20012.79,80051.14
2020-09-25,Reversal,0.0,40025.57,40025.57
2020-09-25,Tax,0.0,10006.39,30019.18
2020-09-25,Interest,0.0,5003.2,25015.98
2020-09-25,Miscellaneous,0.0,12507.99,12507.99
2020-09-25,RTGS,0.0,12507.99,0.0
2020-09-25,ATM,880281.0,0.0,880281.0
2020-09-25,Purchase,0.0,880281.0,0.0
2020-09-25,Purchase,5.0,0.0,5.0
2020-09-25,RTGS,59.56,0.0,64.56
2020-09-25,Interest,0.0,32.28,32.28
2020-09-25,Transfer,0.0,10.76,21.52
2020-09-25,Bill,1609.7,0.0,1631.22
2020-09-25,Cash,0.0,163.12,1468.1
2020-09-25,RTGS,0.0,183.51,1284.59
2020-09-25,Cash,22.6,0.0,1307.19
2020-09-25,ATM,4.0,0.0,1311.19
2020-09-25,Miscellaneous,0.0,218.53,1092.66
2020-09-25,Reversal,53.9,0.0,1146.56
2020-09-25,NEFT,2961.98,0.0,4108.54
2020-09-26,RTGS,0.0,456.5,3652.04
2020-09-26,Tax,18469.0,0.0,22121.04
2020-09-26,Cheque,7.47,0.0,22128.51
2020-09-26,Tax,342.0,0.0,22470.51
2020-09-26,Miscellaneous,0.0,5617.63,16852.88
2020-09-26,RTGS,0.0,8426.44,8426.44
2020-09-26,IMPS,132944.0,0.0,141370.44
2020-09-26,Tax,3262.7,0.0,144633.14
2020-09-26,Cheque,130626.0,0.0,275259.14
2020-09-26,Transfer,6.0,0.0,275265.14
2020-09-26,Commission,0.0,137632.57,137632.57
2020-09-26,Miscellaneous,0.0,22938.76,114693.81
2020-09-26,Reversal,359116.5,0.0,473810.31
2020-09-26,RTGS,2.0,0.0,473812.31
2020-09-26,Bill,6.0,0.0,473818.31
2020-09-27,IMPS,356.0,0.0,474174.31
2020-09-27,ATM,0.0,67739.19,406435.12
2020-09-27,Bill,2347.0,0.0,408782.12
2020-09-27,Interest,0.0,204391.06,204391.06
2020-09-27,Debit Card,216398.6,0.0,420789.66
2020-09-27,RTGS,0.0,52598.71,368190.95
2020-09-28,Tax,22.0,0.0,368212.95
2020-09-28,IMPS,1.0,0.0,368213.95
2020-09-28,Reversal,0.0,40912.66,327301.29
2020-09-28,Transfer,0.0,46757.33,280543.96
2020-09-28,Interest,0.0,140271.98,140271.98
2020-09-28,NEFT,0.0,28054.4,112217.58
2020-09-28,Cash,290.9,0.0,112508.48
2020-09-28,RTGS,105.0,0.0,112613.48
2020-09-28,Cheque,11949.3,0.0,124562.78
2020-09-28,Bill,227.0,0.0,124789.78
2020-09-28,Miscellaneous,0.0,124789.78,0.0
2020-09-28,Bill,795860.0,0.0,795860.0
2020-09-28,Miscellaneous,0.0,397930.0,397930.0
2020-09-28,Cheque,0.0,132643.33,265286.67
2020-09-28,Debit Card,3346.01,0.0,268632.68
2020-09-28,Bill,239849.8,0.0,508482.48
2020-09-28,Commission,0.0,101696.5,406785.98
2020-09-28,Bill,140293.0,0.0,547078.98
2020-09-28,Tax,20370.0,0.0,567448.98
2020-09-28,Tax,0.0,70931.12,496517.86
2020-09-28,Cheque,0.0,165505.95,331011.91
2020-09-28,Miscellaneous,437.54,0.0,331449.45
2020-09-28,Reversal,0.1,0.0,331449.55
2020-09-28,NEFT,3.8,0.0,331453.35
2020-09-28,IMPS,0.0,331453.35,0.0
2020-09-28,Reversal,135.0,0.0,135.0
2020-09-28,ATM,0.0,45.0,90.0
2020-09-28,Miscellaneous,31826.0,0.0,31916.0
2020-09-28,ATM,13495.0,0.0,45411.0
2020-09-28,Miscellaneous,0.0,5676.38,39734.62
2020-09-29,Bill,0.0,39734.62,0.0
2020-09-29,Tax,197039.0,0.0,197039.0
2020-09-29,Cash,0.0,28148.43,168890.57
2020-09-29,Transfer,409.2,0.0,169299.77
2020-09-29,Debit Card,51999.75,0.0,221299.52
2020-09-29,RTGS,1174037.5,0.0,1395337.02
2020-09-29,Tax,31959.58,0.0,1427296.6
2020-09-29,Purchase,204111.9,0.0,1631408.5
2020-09-29,RTGS,3.55,0.0,1631412.05
2020-09-29,Bill,1758800.5,0.0,3390212.55
2020-09-29,Reversal,0.0,1130070.85,2260141.7
2020-09-29,Debit Card,0.0,376690.28,1883451.42
2020-09-29,ATM,0.0,1883451.42,0.0
2020-09-29,Purchase,1.9,0.0,1.9
2020-09-29,Transfer,0.0,0.38,1.52
2020-09-29,ATM,0.0,0.15,1.37
2020-09-29,Interest,0.0,0.34,1.03
2020-09-29,Transfer,3126.6,0.0,3127.63
2020-09-29,Cheque,4058.9,0.0,7186.53
2020-09-29,IMPS,434432.0,0.0,441618.53
2020-09-29,RTGS,0.0,110404.63,331213.9
2020-09-29,Interest,0.0,33121.39,298092.51
2020-09-29,Cheque,0.0,49682.09,248410.42
2020-09-29,Reversal,18265.67,0.0,266676.09
2020-09-29,ATM,0.0,53335.22,213340.87
2020-09-29,Miscellaneous,521.7,0.0,213862.57
2020-09-29,IMPS,468020.25,0.0,681882.82
2020-09-29,NEFT,0.0,97411.83,584470.99
2020-09-29,Cheque,62.0,0.0,584532.99
2020-09-29,Commission,1.0,0.0,584533.99
2020-09-29,Miscellaneous,1238.7,0.0,585772.69
2020-09-29,Tax,0.0,292886.35,292886.34
2020-09-29,Tax,0.0,48814.39,244071.95
2020-09-29,Reversal,6.0,0.0,244077.95
2020-09-29,IMPS,0.0,40679.66,203398.29
2020-09-29,RTGS,26894.0,0.0,230292.29
2020-09-29,Bill,2051.11,0.0,232343.4
2020-09-29,Commission,3385.0,0.0,235728.4
2020-09-29,Miscellaneous,0.0,23572.84,212155.56
2020-09-29,Reversal,4.3,0.0,212159.86
2020-09-29,NEFT,0.0,26519.98,185639.88
2020-09-29,Purchase,0.0,92819.94,92819.94
2020-09-29,Debit Card,0.0,9281.99,83537.95
2020-09-29,Cheque,244924.0,0.0,328461.95
2020-09-29,Reversal,1260349.8,0.0,1588811.75
2020-09-29,Transfer,0.0,794405.88,794405.88
2020-09-29,Bill,0.0,397202.94,397202.94
2020-09-29,Debit Card,47.0,0.0,397249.94
2020-09-29,Cash,70166.09,0.0,467416.03
2020-09-29,Interest,0.0,66773.72,400642.31
2020-09-29,Miscellaneous,1142374.2,0.0,1543016.51
2020-09-29,NEFT,0.0,171446.28,1371570.23
2020-09-29,Commission,0.0,457190.08,914380.15
2020-09-29,Transfer,2010138.0,0.0,2924518.15
2020-09-29,Commission,14925.0,0.0,2939443.15
2020-09-29,IMPS,222.13,0.0,2939665.28
2020-09-29,Tax,25013.9,0.0,2964679.18
2020-09-29,Interest,227195.0,0.0,3191874.18
2020-09-29,Cheque,170201.53,0.0,3362075.71
2020-09-29,Purchase,184969.75,0.0,3547045.46
2020-09-29,Tax,0.0,591174.24,2955871.22
2020-09-29,Bill,4.0,0.0,2955875.22
2020-09-29,Purchase,32595.7,0.0,2988470.92
2020-09-29,Purchase,15.87,0.0,2988486.79
2020-09-29,Transfer,174.4,0.0,2988661.19
2020-09-29,Reversal,0.0,426951.6,2561709.59
2020-09-29,IMPS,30758.8,0.0,2592468.39
2020-09-29,Purchase,0.0,324058.55,2268409.84
2020-09-29,Transfer,2.82,0.0,2268412.66
2020-09-29,Interest,56345.0,0.0,2324757.66
2020-09-29,NEFT,0.0,2324757.66,0.0
2020-09-29,Debit Card,3.7,0.0,3.7
2020-09-29,Purchase,735.26,0.0,738.96
2020-09-29,Reversal,0.0,0.0,738.96
2020-09-29,Bill,1227.55,0.0,1966.51
2020-09-29,IMPS,0.0,491.63,1474.88
2020-09-29,Bill,0.0,294.98,1179.9
2020-09-29,Commission,0.0,131.1,1048.8
2020-09-29,RTGS,0.5,0.0,1049.3
2020-09-29,Interest,196.0,0.0,1245.3
2020-09-29,Tax,255.0,0.0,1500.3
2020-09-29,Bill,0.0,300.06,1200.24
2020-09-29,ATM,0.0,133.36,1066.88
2020-09-29,Debit Card,1.0,0.0,1067.88
2020-09-29,Cash,0.0,177.98,889.9
2020-09-29,NEFT,115182.0,0.0,116071.9
2020-09-29,Transfer,47.44,0.0,116119.34
2020-09-29,Debit Card,0.0,116119.34,0.0
2020-09-29,Transfer,150321.8,0.0,150321.8
2020-09-30,NEFT,937004.0,0.0,1087325.8
2020-09-30,Cash,0.0,1087325.8,0.0
2020-09-30,Cash,543.57,0.0,543.57
2020-10-01,Interest,6.1,0.0,549.67
2020-10-01,Transfer,0.0,274.84,274.83
2020-10-01,Reversal,1.9,0.0,276.73
2020-10-02,RTGS,8.8,0.0,285.53
2020-10-02,RTGS,0.0,95.18,190.35
2020-10-02,IMPS,249488.31,0.0,249678.66
2020-10-02,Cheque,0.0,49935.73,199742.93
2020-10-02,Reversal,3.5,0.0,199746.43
2020-10-02,Cheque,0.0,39949.29,159797.14
2020-10-02,Cheque,1948.0,0.0,161745.14
2020-10-02,RTGS,6.04,0.0,161751.18
2020-10-02,Cheque,155.5,0.0,161906.68
2020-10-02,Debit Card,1130138.75,0.0,1292045.43
2020-10-02,Cash,2.34,0.0,1292047.77
2020-10-02,Transfer,0.0,129204.78,1162842.99
2020-10-02,Purchase,0.0,232568.6,930274.39
2020-10-02,ATM,0.0,310091.46,620182.93
2020-10-02,Bill,5096.8,0.0,625279.73
2020-10-02,Cash,210282.0,0.0,835561.73
2020-10-02,Bill,0.0,119365.96,716195.77
2020-10-02,RTGS,27123.5,0.0,743319.27
2020-10-02,Cash,4.0,0.0,743323.27
2020-10-02,Purchase,0.0,92915.41,650407.86
2020-10-02,Tax,0.0,65040.79,585367.07
2020-10-02,Debit Card,0.0,292683.54,292683.53
2020-10-02,IMPS,43865.2,0.0,336548.73
2020-10-02,Cash,0.0,168274.37,168274.36
2020-10-02,Reversal,14079.8,0.0,182354.16
2020-10-02,Transfer,0.0,26050.59,156303.57
2020-10-02,RTGS,0.0,22329.08,133974.49
2020-10-02,Cheque,0.0,66987.25,66987.24
2020-10-02,Tax,0.0,9569.61,57417.63
2020-10-02,Cheque,0.0,14354.41,43063.22
2020-10-02,Reversal,0.0,5382.9,37680.32
2020-10-02,Bill,401.8,0.0,38082.12
2020-10-02,Transfer,0.0,12694.04,25388.08
2020-10-02,Interest,232990.0,0.0,258378.08
2020-10-02,Cheque,0.0,43063.01,215315.07
2020-10-02,NEFT,1710818.0,0.0,1926133.07
2020-10-02,NEFT,0.0,192613.31,1733519.76
2020-10-02,Bill,1363.7,0.0,1734883.46
2020-10-02,RTGS,22.9,0.0,1734906.36
2020-10-02,NEFT,4070.0,0.0,1738976.36
2020-10-02,Cash,214076.0,0.0,1953052.36
2020-10-02,Interest,1173171.0,0.0,3126223.36
2020-10-02,Reversal,1118.76,0.0,3127342.12
2020-10-02,Debit Card,2750.0,0.0,3130092.12
2020-10-02,Purchase,0.0,1565046.06,1565046.06
2020-10-02,RTGS,202576.7,0.0,1767622.76
2020-10-02,ATM,0.0,220952.85,1546669.92
2020-10-03,Cheque,587499.25,0.0,2134169.17
2020-10-03,Bill,8082.0,0.0,2142251.17
2020-10-03,RTGS,0.0,2142251.17,0.0
2020-10-03,Commission,11484.0,0.0,11484.0
2020-10-03,Commission,217350.0,0.0,228834.0
2020-10-03,Bill,0.0,25426.0,203408.0
2020-10-03,Bill,0.0,29058.29,174349.71
2020-10-03,Commission,29240.5,0.0,203590.21
2020-10-04,Commission,3.2,0.0,203593.41
2020-10-04,RTGS,51.7,0.0,203645.11
2020-10-04,Cash,3285.0,0.0,206930.11
2020-10-04,Miscellaneous,8.29,0.0,206938.4
2020-10-04,Commission,177106.5,0.0,384044.9
2020-10-04,Cheque,0.0,192022.45,192022.45
2020-10-04,Cash,0.0,192022.45,0.0
2020-10-04,Miscellaneous,1.3,0.0,1.3
2020-10-04,RTGS,24.5,0.0,25.8
2020-10-04,Cheque,0.0,25.8,0.0
2020-10-04,Bill,6.0,0.0,6.0
2020-10-04,Reversal,0.0,2.0,4.0
2020-10-04,Interest,0.0,0.44,3.56
2020-10-04,Purchase,0.0,3.56,0.0
2020-10-04,NEFT,18954.0,0.0,18954.0
2020-10-04,Interest,1285838.0,0.0,1304792.0
2020-10-04,RTGS,0.0,260958.4,1043833.6
2020-10-04,Reversal,5.99,0.0,1043839.59
2020-10-04,Debit Card,2078410.8,0.0,3122250.39
2020-10-04,Cheque,48.0,0.0,3122298.39
2020-10-04,Tax,0.0,1040766.13,2081532.26
2020-10-04,Transfer,2245.03,0.0,2083777.29
2020-10-04,Transfer,1761181.75,0.0,3844959.04
2020-10-04,Cash,840932.0,0.0,4685891.04
2020-10-04,IMPS,757.0,0.0,4686648.04
2020-10-04,Cash,3944.21,0.0,4690592.25
2020-10-04,Cash,1640720.8,0.0,6331313.05
2020-10-04,Bill,1557.5,0.0,6332870.55
2020-10-04,Interest,252952.8,0.0,6585823.35
2020-10-04,Commission,0.0,731758.15,5854065.2
2020-10-04,Tax,0.0,650451.69,5203613.51
2020-10-04,Purchase,0.0,1300903.38,3902710.13
2020-10-04,Reversal,0.0,1300903.38,2601806.75
2020-10-04,Purchase,0.0,260180.68,2341626.08
2020-10-04,Transfer,23607.36,0.0,2365233.44
2020-10-04,Purchase,0.0,295654.18,2069579.26
2020-10-04,IMPS,0.0,413915.85,1655663.41
2020-10-04,NEFT,0.0,551887.8,1103775.61
2020-10-04,RTGS,0.0,157682.23,946093.38
2020-10-04,Miscellaneous,47.0,0.0,946140.38
2020-10-04,NEFT,0.0,118267.55,827872.83
2020-10-04,IMPS,0.0,206968.21,620904.62
2020-10-04,Commission,0.0,88700.66,532203.96
2020-10-04,IMPS,1377162.5,0.0,1909366.46
2020-10-04,NEFT,0.0,636455.49,1272910.97
2020-10-04,NEFT,0.0,254582.19,1018328.78
2020-10-04,Reversal,29206.7,0.0,1047535.48
2020-10-04,Bill,0.0,104753.55,942781.93
2020-10-04,Interest,1967989.2,0.0,2910771.13
2020-10-04,NEFT,1781135.0,0.0,4691906.13
2020-10-04,Cheque,0.0,781984.36,3909921.78
2020-10-04,Interest,3796.19,0.0,3913717.97
2020-10-04,Cash,98351.03,0.0,4012069.0
2020-10-04,Interest,0.0,4012069.0,0.0
2020-10-04,Interest,1.3,0.0,1.3
2020-10-04,Reversal,55.2,0.0,56.5
2020-10-04,Reversal,1091.0,0.0,1147.5
2020-10-04,Commission,0.0,191.25,956.25
2020-10-04,Transfer,3717.58,0.0,4673.83
2020-10-04,Purchase,1883062.0,0.0,1887735.83
2020-10-04,Transfer,0.0,209748.43,1677987.4
2020-10-04,Reversal,1815.0,0.0,1679802.4
2020-10-04,Transfer,221.0,0.0,1680023.4
2020-10-04,ATM,0.0,420005.85,1260017.55
2020-10-04,RTGS,0.0,210002.93,1050014.62
2020-10-04,Reversal,2856.74,0.0,1052871.36
2020-10-04,Cash,716.97,0.0,1053588.33
2020-10-05,Miscellaneous,0.0,526794.17,526794.16
2020-10-05,RTGS,0.0,263397.08,263397.08
2020-10-05,Debit Card,46.0,0.0,263443.08
2020-10-05,Transfer,3697.1,0.0,267140.18
2020-10-05,Purchase,0.0,38162.88,228977.3
2020-10-05,Interest,0.0,28622.16,200355.14
2020-10-05,Bill,0.0,22261.68,178093.46
2020-10-05,Cheque,0.0,59364.49,118728.97
2020-10-05,Cash,5.0,0.0,118733.97
2020-10-05,RTGS,0.0,13192.66,105541.31
2020-10-05,IMPS,7.0,0.0,105548.31
2020-10-05,Debit Card,0.0,105548.31,0.0
2020-10-05,Commission,62640.0,0.0,62640.0
2020-10-05,Commission,593.0,0.0,63233.0
2020-10-05,NEFT,55.62,0.0,63288.62
2020-10-05,ATM,23007.0,0.0,86295.62
2020-10-05,Purchase,1318.0,0.0,87613.62
2020-10-05,Cheque,223234.03,0.0,310847.65
2020-10-05,RTGS,5.7,0.0,310853.35
2020-10-05,IMPS,0.0,62170.67,248682.68
2020-10-05,IMPS,0.0,27631.41,221051.27
2020-10-05,Cash,0.0,73683.76,147367.51
2020-10-05,Bill,0.0,18420.94,128946.57
2020-10-05,Debit Card,34472.0,0.0,163418.57
2020-10-05,IMPS,0.0,23345.51,140073.06
2020-10-05,Cash,0.0,46691.02,93382.04
2020-10-05,Tax,2115.5,0.0,95497.54
2020-10-05,Cash,1034.7,0.0,96532.24
2020-10-05,Tax,35.19,0.0,96567.43
2020-10-05,NEFT,0.0,10729.71,85837.72
2020-10-05,NEFT,0.0,10729.72,75108.0
2020-10-05,RTGS,0.0,7510.8,67597.2
2020-10-05,Miscellaneous,0.0,22532.4,45064.8
2020-10-05,Reversal,0.0,7510.8,37554.0
2020-10-05,Cash,0.0,9388.5,28165.5
2020-10-05,Commission,4.1,0.0,28169.6
2020-10-05,Bill,4.0,0.0,28173.6
2020-10-05,Purchase,0.0,2817.36,25356.24
2020-10-05,Purchase,200.3,0.0,25556.54
2020-10-05,ATM,8677.2,0.0,34233.74
2020-10-05,Tax,0.0,3803.75,30429.99
2020-10-05,ATM,0.0,7607.5,22822.49
2020-10-05,Purchase,694868.0,0.0,717690.49
2020-10-05,Reversal,188539.97,0.0,906230.46
2020-10-05,Debit Card,0.0,453115.23,453115.23
2020-10-05,Purchase,220244.7,0.0,673359.93
2020-10-05,Interest,18277.0,0.0,691636.93
2020-10-05,Cash,0.0,230545.64,461091.29
2020-10-05,IMPS,1431824.5,0.0,1892915.79
2020-10-05,Cash,0.0,378583.16,1514332.63
2020-10-05,Miscellaneous,0.0,151433.26,1362899.37
2020-10-05,RTGS,0.0,227149.9,1135749.48
2020-10-05,Bill,1.7,0.0,1135751.18
2020-10-06,Interest,61.0,0.0,1135812.18
2020-10-06,Cash,0.0,378604.06,757208.12
2020-10-06,RTGS,0.0,252402.71,504805.41
2020-10-06,Commission,4.0,0.0,504809.41
2020-10-06,Tax,0.0,50480.94,454328.47
2020-10-06,Reversal,0.0,56791.06,397537.41
2020-10-06,Bill,31852.0,0.0,429389.41
2020-10-06,Bill,0.0,53673.68,375715.73
2020-10-06,Cheque,54.2,0.0,375769.93
2020-10-06,RTGS,24981.0,0.0,400750.93
2020-10-06,Transfer,0.0,57250.13,343500.8
2020-10-06,ATM,0.0,57250.13,286250.67
2020-10-06,IMPS,0.0,57250.13,229000.54
2020-10-06,Commission,27424.8,0.0,256425.34
2020-10-06,Purchase,0.0,85475.11,170950.23
2020-10-06,Commission,63.0,0.0,171013.23
2020-10-06,Bill,0.0,57004.41,114008.82
2020-10-06,Transfer,0.0,16286.97,97721.85
2020-10-06,Miscellaneous,0.0,16286.98,81434.88
2020-10-06,Transfer,3818.0,0.0,85252.88
2020-10-06,ATM,1760.9,0.0,87013.78
2020-10-06,RTGS,967.59,0.0,87981.37
2020-10-06,Interest,0.0,10997.67,76983.7
2020-10-06,IMPS,22.6,0.0,77006.3
2020-10-06,Bill,25392.96,0.0,102399.26
2020-10-06,IMPS,0.0,14628.47,87770.79
2020-10-06,IMPS,0.0,9752.31,78018.48
2020-10-06,Commission,49.0,0.0,78067.48
2020-10-06,NEFT,26325.0,0.0,104392.48
2020-10-06,Reversal,0.0,20878.5,83513.98
2020-10-06,Cheque,0.0,41756.99,41756.99
2020-10-07,RTGS,0.0,5965.28,35791.71
2020-10-07,Tax,0.0,35791.71,0.0
2020-10-07,Debit Card,3655.9,0.0,3655.9
2020-10-07,Interest,7.0,0.0,3662.9
2020-10-07,Bill,227799.81,0.0,231462.71
2020-10-07,Purchase,2921.6,0.0,234384.31
2020-10-07,ATM,0.0,234384.31,0.0
2020-10-07,Cash,1925.8,0.0,1925.8
2020-10-07,Interest,0.0,240.73,1685.08
2020-10-07,Bill,3856.0,0.0,5541.08
2020-10-07,Debit Card,0.0,791.58,4749.5
2020-10-07,Bill,8376.9,0.0,13126.4
2020-10-07,Bill,0.0,13126.4,0.0
2020-10-07,Tax,1145740.25,0.0,1145740.25
2020-10-07,Transfer,0.0,114574.03,1031166.22
2020-10-07,Cheque,0.0,114574.02,916592.2
2020-10-08,Miscellaneous,0.0,91659.22,824932.98
2020-10-08,Purchase,0.0,206233.25,618699.74
2020-10-08,Bill,0.0,154674.94,464024.8
2020-10-08,Miscellaneous,6.4,0.0,464031.2
2020-10-08,Cheque,5236.0,0.0,469267.2
2020-10-08,NEFT,1969778.0,0.0,2439045.2
2020-10-08,Transfer,977924.0,0.0,3416969.2
2020-10-08,Bill,0.0,379663.24,3037305.96
2020-10-08,Debit Card,0.0,379663.25,2657642.72
2020-10-08,Interest,1465813.25,0.0,4123455.97
2020-10-08,Commission,30867.7,0.0,4154323.67
2020-10-08,Reversal,18557.0,0.0,4172880.67
2020-10-08,Commission,1237.0,0.0,4174117.67
2020-10-08,NEFT,0.0,521764.71,3652352.96
2020-10-08,Cheque,57.4,0.0,3652410.36
2020-10-08,Tax,0.0,365241.04,3287169.32
2020-10-08,Bill,52.0,0.0,3287221.32
2020-10-08,Commission,0.0,821805.33,2465415.99
2020-10-08,Cash,0.0,616354.0,1849061.99
2020-10-08,Tax,234609.1,0.0,2083671.09
2020-10-08,Bill,27284.35,0.0,2110955.44
2020-10-09,Reversal,6606.97,0.0,2117562.41
2020-10-09,Purchase,0.0,211756.24,1905806.17
2020-10-09,RTGS,0.0,476451.54,1429354.63
2020-10-09,Reversal,0.0,714677.32,714677.32
2020-10-09,Bill,37044.16,0.0,751721.48
2020-10-09,Debit Card,0.0,751721.48,0.0
2020-10-09,Debit Card,181.64,0.0,181.64
2020-10-09,Commission,1463.5,0.0,1645.14
2020-10-09,Purchase,0.0,274.19,1370.95
2020-10-09,Reversal,0.0,228.49,1142.46
2020-10-09,Cheque,0.0,571.23,571.23
2020-10-09,Interest,0.0,571.23,0.0
2020-10-09,Debit Card,225.0,0.0,225.0
2020-10-09,ATM,0.0,56.25,168.75
2020-10-09,Cheque,0.0,21.09,147.66
2020-10-09,Tax,0.0,18.46,129.2
2020-10-09,Transfer,155745.3,0.0,155874.5
2020-10-09,Commission,6.17,0.0,155880.67
2020-10-09,Cheque,0.0,19485.08,136395.59
2020-10-09,NEFT,61.0,0.0,136456.59
2020-10-09,Interest,23.18,0.0,136479.77
2020-10-09,Transfer,36056.9,0.0,172536.67
2020-10-09,Bill,7037.0,0.0,179573.67
2020-10-09,Miscellaneous,30.9,0.0,179604.57
2020-10-09,ATM,0.0,179604.57,0.0
2020-10-09,NEFT,39498.2,0.0,39498.2
2020-10-09,ATM,0.0,4388.69,35109.51
2020-10-09,Interest,4.5,0.0,35114.01
2020-10-09,Transfer,0.0,5852.34,29261.68
2020-10-09,Transfer,0.0,5852.34,23409.34
2020-10-09,Debit Card,0.11,0.0,23409.45
2020-10-09,RTGS,22926.0,0.0,46335.45
2020-10-09,NEFT,108.0,0.0,46443.45
2020-10-09,Purchase,0.0,11610.86,34832.59
2020-10-09,Purchase,119862.5,0.0,154695.09
2020-10-09,Interest,0.0,17188.34,137506.75
2020-10-10,Commission,3.6,0.0,137510.35
2020-10-10,Debit Card,44.0,0.0,137554.35
2020-10-10,IMPS,24249.6,0.0,161803.95
2020-10-10,Purchase,0.0,53934.65,107869.3
2020-10-10,Interest,0.0,26967.33,80901.98
2020-10-10,Debit Card,89.0,0.0,80990.98
2020-10-10,NEFT,24703.0,0.0,105693.98
2020-10-10,Transfer,0.0,52846.99,52846.99
2020-10-10,Debit Card,30943.2,0.0,83790.19
2020-10-10,Purchase,68237.12,0.0,152027.31
2020-10-10,Transfer,0.0,50675.77,101351.54
2020-10-10,RTGS,0.0,16891.92,84459.62
2020-10-10,NEFT,9.2,0.0,84468.82
2020-10-10,Tax,29558.81,0.0,114027.63
2020-10-10,Transfer,48136.0,0.0,162163.63
2020-10-10,Purchase,1708598.0,0.0,1870761.63
2020-10-11,IMPS,0.0,311793.61,1558968.02
2020-10-11,Purchase,0.0,1558968.02,0.0
2020-10-11,IMPS,4.0,0.0,4.0
2020-10-11,Transfer,25705.76,0.0,25709.76
2020-10-11,Commission,0.0,5141.95,20567.81
2020-10-11,NEFT,7.34,0.0,20575.15
2020-10-11,IMPS,0.0,4115.03,16460.12
2020-10-11,Interest,2607.0,0.0,19067.12
2020-10-11,Transfer,122485.4,0.0,141552.52
2020-10-11,Interest,0.0,14155.25,127397.27
2020-10-11,Commission,0.0,12739.73,114657.54
2020-10-11,Transfer,0.0,38219.18,76438.36
2020-10-11,Bill,31.4,0.0,76469.76
2020-10-11,Transfer,0.0,8496.64,67973.12
2020-10-11,RTGS,31.0,0.0,68004.12
2020-10-11,Cheque,0.0,11334.02,56670.1
2020-10-11,Transfer,5.07,0.0,56675.17
2020-10-12,Miscellaneous,0.0,11335.03,45340.14
2020-10-12,Reversal,10.3,0.0,45350.44
2020-10-12,Tax,0.0,9070.09,36280.35
2020-10-12,Transfer,4.52,0.0,36284.87
2020-10-12,RTGS,47.0,0.0,36331.87
2020-10-12,Purchase,0.0,6055.31,30276.56
2020-10-12,IMPS,57.0,0.0,30333.56
2020-10-12,NEFT,0.0,30333.56,0.0
2020-10-12,IMPS,7.0,0.0,7.0
2020-10-12,Purchase,233720.59,0.0,233727.59
2020-10-12,IMPS,15055.8,0.0,248783.39
2020-10-12,Commission,11152.91,0.0,259936.3
2020-10-12,Cash,0.0,37133.76,222802.54
2020-10-12,Cheque,31725.37,0.0,254527.91
2020-10-12,Tax,0.0,254527.91,0.0
2020-10-12,NEFT,7.0,0.0,7.0
2020-10-12,ATM,0.0,2.33,4.67
2020-10-13,Miscellaneous,8030.0,0.0,8034.67
2020-10-13,Commission,0.0,2678.22,5356.45
2020-10-13,Reversal,5.62,0.0,5362.07
2020-10-13,Tax,0.0,536.21,4825.86
2020-10-13,Reversal,0.0,804.31,4021.55
2020-10-13,ATM,391.98,0.0,4413.53
2020-10-13,Purchase,25757.1,0.0,30170.63
2020-10-13,NEFT,0.0,5028.44,25142.19
2020-10-13,Cash,2237.0,0.0,27379.19
2020-10-13,Reversal,0.0,13689.6,13689.6
2020-10-13,Purchase,0.0,1711.2,11978.4
2020-10-13,Tax,0.0,2395.68,9582.72
2020-10-13,Miscellaneous,0.0,3194.24,6388.48
2020-10-13,Tax,0.0,6388.48,0.0
2020-10-13,Reversal,1747.21,0.0,1747.21
2020-10-13,NEFT,8.0,0.0,1755.21
2020-10-13,Bill,773782.75,0.0,775537.96
2020-10-13,Commission,1724404.0,0.0,2499941.96
2020-10-13,Cheque,258749.53,0.0,2758691.49
2020-10-13,Interest,30106.0,0.0,2788797.49
2020-10-13,RTGS,0.0,1394398.75,1394398.74
2020-10-13,Tax,22762.0,0.0,1417160.74
2020-10-13,IMPS,27520.2,0.0,1444680.94
2020-10-13,IMPS,0.0,1444680.94,0.0
2020-10-13,Cash,4.0,0.0,4.0
2020-10-13,Transfer,0.0,2.0,2.0
2020-10-13,IMPS,1954002.0,0.0,1954004.0
2020-10-13,Bill,0.0,279143.43,1674860.57
2020-10-13,Cheque,0.0,186095.62,1488764.95
2020-10-13,Cash,0.0,372191.24,1116573.71
2020-10-13,IMPS,18.4,0.0,1116592.11
2020-10-13,Reversal,6.0,0.0,1116598.11
2020-10-13,Transfer,0.0,558299.06,558299.06
2020-10-13,Transfer,1.04,0.0,558300.1
2020-10-14,Debit Card,4.0,0.0,558304.1
2020-10-14,Cash,0.0,55830.41,502473.69
2020-10-14,RTGS,0.0,50247.37,452226.32
2020-10-14,Cheque,0.0,56528.29,395698.03
2020-10-14,IMPS,73819.0,0.0,469517.03
2020-10-14,Cash,0.0,46951.7,422565.33
2020-10-14,Tax,0.0,84513.07,338052.26
2020-10-14,Miscellaneous,1.76,0.0,338054.02
2020-10-14,Commission,0.0,37561.56,300492.46
2020-10-14,ATM,41.0,0.0,300533.46
2020-10-14,Tax,0.0,75133.37,225400.1
2020-10-14,ATM,257266.0,0.0,482666.1
2020-10-14,NEFT,0.0,80444.35,402221.75
2020-10-14,Reversal,3079.0,0.0,405300.75
2020-10-14,ATM,58.0,0.0,405358.75
2020-10-14,Commission,7.94,0.0,405366.69
2020-10-14,Interest,0.0,101341.67,304025.02
2020-10-14,Purchase,0.0,60805.0,243220.02
2020-10-14,Miscellaneous,0.0,48644.0,194576.02
2020-10-14,Tax,0.0,38915.2,155660.82
2020-10-14,Debit Card,0.0,51886.94,103773.88
2020-10-14,NEFT,0.0,20754.78,83019.1
2020-10-14,IMPS,7.0,0.0,83026.1
2020-10-14,Debit Card,0.0,20756.53,62269.58
2020-10-15,Bill,0.0,8895.65,53373.93
2020-10-15,ATM,0.0,6671.74,46702.19
2020-10-15,Commission,31.32,0.0,46733.51
2020-10-15,RTGS,20480.96,0.0,67214.47
2020-10-15,ATM,0.0,13442.89,53771.58
2020-10-15,Debit Card,0.0,26885.79,26885.79
2020-10-15,IMPS,0.0,2688.58,24197.21
2020-10-15,RTGS,0.0,8065.74,16131.47
2020-10-15,Cash,0.0,2304.5,13826.97
2020-10-15,Cheque,207798.0,0.0,221624.97
2020-10-15,Transfer,0.0,73874.99,147749.98
2020-10-15,Reversal,53066.44,0.0,200816.42
2020-10-15,ATM,0.0,25102.05,175714.37
2020-10-15,Reversal,0.0,17571.44,158142.93
2020-10-15,RTGS,0.0,31628.59,126514.34
2020-10-15,Reversal,822.0,0.0,127336.34
2020-10-15,NEFT,0.0,25467.27,101869.07
2020-10-15,RTGS,0.0,25467.27,76401.8
2020-10-15,RTGS,193986.47,0.0,270388.27
2020-10-15,RTGS,0.0,135194.14,135194.14
2020-10-15,Reversal,0.0,15021.57,120172.57
2020-10-15,RTGS,97986.4,0.0,218158.97
2020-10-15,Cash,0.0,109079.49,109079.48
2020-10-15,Cash,0.0,13634.94,95444.54
2020-10-15,Tax,119396.0,0.0,214840.54
2020-10-15,Commission,0.0,71613.51,143227.03
2020-10-15,Tax,0.0,143227.03,0.0
2020-10-15,Cheque,3157.0,0.0,3157.0
2020-10-15,NEFT,228584.0,0.0,231741.0
2020-10-15,Transfer,0.0,25749.0,205992.0
2020-10-15,Debit Card,0.0,25749.0,180243.0
2020-10-15,RTGS,0.0,22530.38,157712.62
2020-10-15,Cash,2.41,0.0,157715.03
2020-10-15,Commission,2768.5,0.0,160483.53
2020-10-15,Miscellaneous,371.8,0.0,160855.33
2020-10-15,Tax,0.0,32171.07,128684.26
2020-10-15,Interest,9.0,0.0,128693.26
2020-10-15,Commission,612.0,0.0,129305.26
2020-10-15,Tax,0.0,32326.32,96978.94
2020-10-15,Reversal,711632.5,0.0,808611.44
2020-10-15,NEFT,0.0,89845.72,718765.72
2020-10-15,Purchase,0.0,359382.86,359382.86
2020-10-15,Cheque,3.0,0.0,359385.86
2020-10-15,Purchase,0.0,359385.86,0.0
2020-10-15,Reversal,210497.0,0.0,210497.0
2020-10-15,RTGS,0.0,52624.25,157872.75
2020-10-15,Cash,0.0,39468.19,118404.56
2020-10-15,Cash,0.0,13156.06,105248.5
2020-10-15,Bill,0.0,26312.13,78936.38
2020-10-15,Debit Card,0.0,39468.19,39468.19
2020-10-15,Debit Card,0.33,0.0,39468.52
2020-10-15,NEFT,95432.2,0.0,134900.72
2020-10-15,Cash,0.0,13490.07,121410.65
2020-10-15,Reversal,0.0,15176.33,106234.32
2020-10-15,Cheque,0.0,35411.44,70822.88
2020-10-15,NEFT,0.0,7869.21,62953.67
2020-10-15,Interest,54.8,0.0,63008.47
2020-10-16,Debit Card,0.0,7000.94,56007.53
2020-10-16,IMPS,0.0,6223.06,49784.47
2020-10-16,Bill,48.9,0.0,49833.37
2020-10-16,Purchase,5.0,0.0,49838.37
2020-10-16,Debit Card,475.73,0.0,50314.1
2020-10-16,RTGS,419.0,0.0,50733.1
2020-10-16,Miscellaneous,0.0,16911.03,33822.07
2020-10-16,Cash,2371.3,0.0,36193.37
2020-10-16,NEFT,0.0,18096.69,18096.69
2020-10-16,ATM,0.0,6032.23,12064.46
2020-10-16,Tax,5.54,0.0,12070.0
2020-10-16,Bill,0.0,1341.11,10728.89
2020-10-16,Bill,0.0,1532.7,9196.19
2020-10-16,Commission,0.0,3065.4,6130.79
2020-10-16,Miscellaneous,1.0,0.0,6131.79
2020-10-16,Bill,0.0,613.18,5518.61
2020-10-16,RTGS,22606.0,0.0,28124.61
2020-10-16,Purchase,0.0,28124.61,0.0
2020-10-17,Interest,3595.0,0.0,3595.0
2020-10-17,Transfer,168.0,0.0,3763.0
2020-10-17,Reversal,0.0,418.11,3344.89
2020-10-17,IMPS,1667632.75,0.0,1670977.64
2020-10-17,IMPS,0.0,185664.18,1485313.46
2020-10-17,Purchase,0.0,742656.73,742656.73
2020-10-17,Transfer,0.7,0.0,742657.43
2020-10-17,NEFT,18.0,0.0,742675.43
2020-10-17,NEFT,2.0,0.0,742677.43
2020-10-17,Interest,1551561.2,0.0,2294238.63
2020-10-17,Commission,0.0,229423.86,2064814.77
2020-10-17,Reversal,0.0,2064814.77,0.0
2020-10-17,NEFT,1541.32,0.0,1541.32
2020-10-17,Bill,3096.0,0.0,4637.32
2020-10-18,IMPS,0.0,4637.32,0.0
2020-10-18,Interest,261.9,0.0,261.9
2020-10-18,Debit Card,0.0,130.95,130.95
2020-10-18,Commission,0.0,65.48,65.47
2020-10-18,RTGS,4.0,0.0,69.47
2020-10-18,ATM,0.0,7.72,61.75
2020-10-18,Cheque,0.0,10.29,51.46
2020-10-18,RTGS,0.0,17.15,34.31
2020-10-18,NEFT,3672.0,0.0,3706.31
2020-10-18,RTGS,1891023.8,0.0,1894730.11
2020-10-18,IMPS,17.0,0.0,1894747.11
2020-10-18,Purchase,1477269.2,0.0,3372016.31
2020-10-18,IMPS,0.0,1124005.44,2248010.87
2020-10-18,Cash,0.0,749336.96,1498673.91
2020-10-18,RTGS,3.29,0.0,1498677.2
2020-10-18,Debit Card,0.0,249779.53,1248897.67
2020-10-18,Tax,74055.25,0.0,1322952.92
2020-10-18,Debit Card,3708.92,0.0,1326661.84
2020-10-18,ATM,35.5,0.0,1326697.34
2020-10-18,RTGS,0.0,1326697.34,0.0
2020-10-18,Reversal,55373.0,0.0,55373.0
2020-10-18,Transfer,0.0,7910.43,47462.57
2020-10-18,RTGS,128982.0,0.0,176444.57
2020-10-18,Reversal,0.0,19604.95,156839.62
2020-10-18,Commission,0.0,26139.94,130699.68
2020-10-18,Interest,0.0,26139.94,104559.74
2020-10-18,NEFT,0.0,13069.97,91489.77
2020-10-18,Purchase,0.0,10165.53,81324.24
2020-10-18,Transfer,0.0,10165.53,71158.71
2020-10-18,Purchase,1838.0,0.0,72996.71
2020-10-18,Cheque,0.0,72996.71,0.0
2020-10-18,Transfer,981732.0,0.0,981732.0
2020-10-18,ATM,181652.75,0.0,1163384.75
2020-10-18,Tax,0.0,129264.97,1034119.78
2020-10-18,NEFT,0.0,114902.2,919217.58
2020-10-18,Tax,93.88,0.0,919311.46
2020-10-18,Commission,10381.0,0.0,929692.46
2020-10-18,Miscellaneous,163466.6,0.0,1093159.06
2020-10-18,Interest,0.0,273289.77,819869.3
2020-10-18,NEFT,2335.2,0.0,822204.5
2020-10-18,Purchase,7.0,0.0,822211.5
2020-10-18,IMPS,0.0,205552.88,616658.62
2020-10-18,IMPS,1.98,0.0,616660.6
2020-10-18,IMPS,590893.0,0.0,1207553.6
2020-10-18,Tax,0.0,150944.2,1056609.4
2020-10-18,IMPS,0.0,352203.13,704406.27
2020-10-18,NEFT,0.0,78267.36,626138.91
2020-10-18,Tax,34.74,0.0,626173.65
2020-10-18,Commission,0.0,89453.38,536720.27
2020-10-18,Purchase,0.0,67090.03,469630.24
2020-10-18,Interest,0.0,58703.78,410926.46
2020-10-18,Transfer,173210.0,0.0,584136.46
2020-10-18,ATM,0.0,292068.23,292068.23
2020-10-18,Debit Card,0.0,48678.04,243390.19
2020-10-18,Cash,0.0,121695.1,121695.1
2020-10-18,IMPS,0.0,121695.1,0.0
2020-10-18,NEFT,4.09,0.0,4.09
2020-10-18,NEFT,413.2,0.0,417.29
2020-10-18,Miscellaneous,109065.0,0.0,109482.29
2020-10-18,Purchase,0.0,109482.29,0.0
2020-10-18,ATM,1596787.0,0.0,1596787.0
2020-10-18,Reversal,0.0,798393.5,798393.5
2020-10-18,Cash,0.0,99799.19,698594.31
2020-10-18,Interest,1863036.25,0.0,2561630.56
2020-10-18,Cash,15102.0,0.0,2576732.56
2020-10-18,Commission,0.0,515346.51,2061386.05
2020-10-18,Reversal,0.0,515346.51,1546039.54
2020-10-18,Transfer,4.5,0.0,1546044.04
2020-10-18,Reversal,0.0,773022.02,773022.02
2020-10-18,Purchase,225870.0,0.0,998892.02
2020-10-18,Interest,25.6,0.0,998917.62
2020-10-18,Bill,0.0,124864.7,874052.92
2020-10-18,Reversal,0.0,124864.7,749188.22
2020-10-18,Tax,1420.0,0.0,750608.22
2020-10-18,RTGS,0.0,750608.22,0.0
2020-10-18,Tax,91320.7,0.0,91320.7
2020-10-18,RTGS,0.0,9132.07,82188.63
2020-10-18,NEFT,210182.34,0.0,292370.97
2020-10-18,Miscellaneous,0.0,73092.74,219278.23
2020-10-18,Commission,156857.0,0.0,376135.23
2020-10-18,Interest,0.0,62689.21,313446.02
2020-10-18,Bill,1766.0,0.0,315212.02
2020-10-18,Transfer,0.0,78803.01,236409.02
2020-10-18,NEFT,495.0,0.0,236904.02
2020-10-18,Tax,0.0,47380.8,189523.22
2020-10-18,Cash,0.0,63174.41,126348.81
2020-10-18,Transfer,0.0,12634.88,113713.93
2020-10-18,Tax,0.0,22742.79,90971.14
2020-10-18,ATM,0.0,12995.88,77975.26
2020-10-18,Bill,22022.0,0.0,99997.26
2020-10-18,Debit Card,24692.2,0.0,124689.46
2020-10-18,RTGS,714.78,0.0,125404.24
2020-10-18,NEFT,0.0,13933.8,111470.44
2020-10-18,Bill,0.0,12385.6,99084.84
2020-10-18,Debit Card,0.0,14154.98,84929.86
2020-10-18,Purchase,6.0,0.0,84935.86
2020-10-18,Interest,0.0,42467.93,42467.93
2020-10-18,Miscellaneous,70450.22,0.0,112918.15
2020-10-18,Bill,37.0,0.0,112955.15
2020-10-18,Cash,0.0,11295.52,101659.64
2020-10-18,Cash,2581.5,0.0,104241.14
2020-10-18,Interest,20.7,0.0,104261.84
2020-10-18,Tax,0.0,17376.97,86884.87
2020-10-18,Debit Card,0.0,43442.44,43442.44
2020-10-18,Cheque,0.0,4344.24,39098.2
2020-10-18,ATM,42.9,0.0,39141.1
2020-10-18,Cash,0.0,13047.03,26094.07
2020-10-18,Cash,42.0,0.0,26136.07
2020-10-18,Cash,20804.9,0.0,46940.97
2020-10-18,Transfer,0.0,5215.66,41725.31
2020-10-18,IMPS,134705.1,0.0,176430.41
2020-10-18,Cash,1994.0,0.0,178424.41
2020-10-18,ATM,20859.0,0.0,199283.41
2020-10-18,Transfer,0.0,33213.9,166069.51
2020-10-18,Reversal,247116.44,0.0,413185.95
2020-10-18,Cheque,358.25,0.0,413544.2
2020-10-18,Miscellaneous,0.0,41354.42,372189.78
2020-10-18,Tax,20394.0,0.0,392583.78
2020-10-18,Transfer,0.0,392583.78,0.0
2020-10-18,Bill,7.42,0.0,7.42
2020-10-18,IMPS,0.0,0.82,6.6
2020-10-18,RTGS,1962147.75,0.0,1962154.35
2020-10-19,Bill,2127.49,0.0,1964281.84
2020-10-19,Debit Card,0.0,218253.54,1746028.3
2020-10-20,Commission,0.0,218253.54,1527774.76
2020-10-20,RTGS,0.0,381943.69,1145831.07
2020-10-20,Reversal,190038.56,0.0,1335869.63
2020-10-20,Debit Card,0.0,148429.96,1187439.67
2020-10-20,Miscellaneous,26.0,0.0,1187465.67
2020-10-20,Reversal,0.0,118746.57,1068719.1
2020-10-20,NEFT,0.0,356239.7,712479.4
2020-10-20,Commission,0.0,237493.13,474986.27
2020-10-20,Debit Card,325.0,0.0,475311.27
2020-10-20,NEFT,0.0,59413.91,415897.36
2020-10-20,Cash,0.0,103974.34,311923.02
2020-10-20,Tax,0.0,31192.3,280730.72
2020-10-20,Commission,37.9,0.0,280768.62
2020-10-20,Bill,128815.75,0.0,409584.37
2020-10-20,Transfer,162933.0,0.0,572517.37
2020-10-20,NEFT,0.0,57251.74,515265.63
2020-10-20,ATM,28.1,0.0,515293.73
2020-10-20,ATM,63.0,0.0,515356.73
2020-10-20,ATM,4791.51,0.0,520148.24
2020-10-20,NEFT,0.0,52014.82,468133.42
2020-10-20,Reversal,3195.0,0.0,471328.42
2020-10-20,Purchase,0.0,47132.84,424195.58
2020-10-21,Cheque,23.0,0.0,424218.58
2020-10-21,ATM,19966.0,0.0,444184.58
2020-10-21,Commission,369093.0,0.0,813277.58
2020-10-21,Tax,0.0,203319.4,609958.18
2020-10-21,Debit Card,22.8,0.0,609980.98
2020-10-21,Transfer,0.0,304990.49,304990.49
2020-10-21,IMPS,0.0,43570.07,261420.42
2020-10-21,Tax,0.0,37345.77,224074.65
2020-10-21,Transfer,115786.0,0.0,339860.65
2020-10-21,IMPS,8.0,0.0,339868.65
2020-10-21,Bill,0.0,169934.33,169934.32
2020-10-21,NEFT,95086.0,0.0,265020.32
2020-10-21,RTGS,0.0,37860.05,227160.27
2020-10-21,IMPS,235176.5,0.0,462336.77
2020-10-21,Interest,372.0,0.0,462708.77
2020-10-22,ATM,0.0,154236.26,308472.51
2020-10-22,Bill,53.0,0.0,308525.51
2020-10-22,Commission,2075751.0,0.0,2384276.51
2020-10-22,Commission,7.0,0.0,2384283.51
2020-10-22,Reversal,0.0,238428.35,2145855.16
2020-10-22,Bill,6.4,0.0,2145861.56
2020-10-22,Transfer,410.6,0.0,2146272.16
2020-10-23,Commission,0.0,536568.04,1609704.12
2020-10-23,Interest,138.1,0.0,1609842.22
2020-10-23,Miscellaneous,3373.5,0.0,1613215.72
2020-10-23,Miscellaneous,257873.7,0.0,1871089.42
2020-10-24,Interest,0.0,935544.71,935544.71
2020-10-24,Interest,0.0,935544.71,0.0
2020-10-24,ATM,7.96,0.0,7.96
2020-10-24,Transfer,1599888.0,0.0,1599895.96
2020-10-24,Purchase,0.0,228556.57,1371339.39
2020-10-24,Miscellaneous,12493.0,0.0,1383832.39
2020-10-24,NEFT,0.0,345958.1,1037874.29
2020-10-24,IMPS,3.6,0.0,1037877.89
2020-10-24,Transfer,4.0,0.0,1037881.89
2020-10-24,Cheque,0.0,518940.95,518940.94
2020-10-24,ATM,0.0,86490.16,432450.78
2020-10-24,RTGS,0.0,43245.08,389205.7
2020-10-24,Cheque,0.0,38920.57,350285.13
2020-10-24,Reversal,0.0,58380.86,291904.28
2020-10-24,Debit Card,312.85,0.0,292217.13
2020-10-24,Interest,0.0,146108.57,146108.56
2020-10-24,RTGS,1787091.0,0.0,1933199.56
2020-10-24,Tax,348.97,0.0,1933548.53
2020-10-24,Tax,7.0,0.0,1933555.53
2020-10-24,Commission,1361884.25,0.0,3295439.78
2020-10-24,Miscellaneous,0.0,329543.98,2965895.8
2020-10-24,Commission,3870.0,0.0,2969765.8
2020-10-24,IMPS,0.0,329973.98,2639791.82
2020-10-24,NEFT,18559.9,0.0,2658351.72
2020-10-24,ATM,0.0,2658351.72,0.0
2020-10-24,IMPS,35.0,0.0,35.0
2020-10-24,Debit Card,16023.0,0.0,16058.0
2020-10-25,Reversal,19611.0,0.0,35669.0
2020-10-25,Miscellaneous,0.0,3963.22,31705.78
2020-10-25,NEFT,23.0,0.0,31728.78
2020-10-25,Miscellaneous,0.0,4532.68,27196.1
2020-10-25,NEFT,2078.07,0.0,29274.17
2020-10-25,Bill,283.0,0.0,29557.17
2020-10-25,ATM,414.0,0.0,29971.17
2020-10-25,ATM,1695376.5,0.0,1725347.67
2020-10-25,RTGS,0.0,246478.24,1478869.43
2020-10-25,Miscellaneous,0.0,739434.72,739434.72
2020-10-25,Miscellaneous,0.0,123239.12,616195.6
2020-10-25,NEFT,0.0,88027.94,528167.66
2020-10-25,NEFT,0.0,52816.77,475350.89
2020-10-25,NEFT,0.0,158450.3,316900.59
2020-10-25,Interest,3188.0,0.0,320088.59
2020-10-25,Commission,0.0,64017.72,256070.87
2020-10-25,Commission,0.0,25607.09,230463.78
2020-10-25,ATM,103080.0,0.0,333543.78
2020-10-25,Miscellaneous,0.0,83385.95,250157.84
2020-10-25,Interest,0.0,31269.73,218888.11
2020-10-25,Cheque,95.7,0.0,218983.81
2020-10-26,Cheque,0.0,31283.4,187700.41
2020-10-26,RTGS,19.0,0.0,187719.41
2020-10-26,ATM,0.0,18771.94,168947.47
2020-10-26,Cash,0.0,18771.94,150175.53
2020-10-26,NEFT,20182.84,0.0,170358.37
2020-10-27,Cash,6.11,0.0,170364.48
2020-10-27,NEFT,0.0,42591.12,127773.36
2020-10-27,Reversal,13.0,0.0,127786.36
2020-10-27,Cheque,18.0,0.0,127804.36
2020-10-27,IMPS,0.0,25560.87,102243.49
2020-10-28,Tax,54274.31,0.0,156517.8
2020-10-28,Miscellaneous,0.0,156517.8,0.0
2020-10-28,Reversal,8.0,0.0,8.0
2020-10-28,Transfer,568.0,0.0,576.0
2020-10-28,Reversal,1769902.0,0.0,1770478.0
2020-10-28,Reversal,0.0,590159.33,1180318.67
2020-10-28,Tax,186.5,0.0,1180505.17
2020-10-28,Purchase,2017450.75,0.0,3197955.92
2020-10-28,Reversal,0.0,799488.98,2398466.94
2020-10-28,IMPS,1519.0,0.0,2399985.94
2020-10-29,Reversal,0.0,299998.24,2099987.7
2020-10-29,IMPS,843.0,0.0,2100830.7
2020-10-29,Commission,7.7,0.0,2100838.4
2020-10-29,Interest,0.0,233426.49,1867411.91
2020-10-29,Cash,0.0,266773.13,1600638.78
2020-10-29,IMPS,14.18,0.0,1600652.96
2020-10-29,Reversal,22480.98,0.0,1623133.94
2020-10-29,Commission,0.0,162313.39,1460820.55
2020-10-29,Bill,419.88,0.0,1461240.43
2020-10-29,Purchase,0.0,146124.04,1315116.39
2020-10-29,Bill,0.0,187873.77,1127242.62
2020-10-29,ATM,0.0,125249.18,1001993.44
2020-10-29,ATM,82.5,0.0,1002075.94
2020-10-29,RTGS,90.98,0.0,1002166.92
2020-10-29,Interest,0.0,111351.88,890815.04
2020-10-29,Commission,0.0,296938.35,593876.69
2020-10-29,RTGS,2013326.0,0.0,2607202.69
2020-10-29,Commission,0.0,521440.54,2085762.15
2020-10-29,Debit Card,0.0,695254.05,1390508.1
2020-10-29,Cash,0.0,695254.05,695254.05
2020-10-29,ATM,0.0,139050.81,556203.24
2020-10-29,Interest,495357.0,0.0,1051560.24
2020-10-29,Miscellaneous,45.0,0.0,1051605.24
2020-10-29,Transfer,0.0,116845.03,934760.21
2020-10-29,IMPS,98096.5,0.0,1032856.71
2020-10-29,Bill,0.0,344285.57,688571.14
2020-10-29,IMPS,0.0,344285.57,344285.57
2020-10-29,Bill,0.0,344285.57,0.0
2020-10-29,Bill,721519.0,0.0,721519.0
2020-10-29,IMPS,0.0,240506.33,481012.67
2020-10-29,Cheque,0.0,120253.17,360759.5
2020-10-29,Cash,0.0,51537.07,309222.43
2020-10-29,Transfer,1968.0,0.0,311190.43
2020-10-29,Commission,513.29,0.0,311703.72
2020-10-29,Bill,7.0,0.0,311710.72
2020-10-29,RTGS,503.93,0.0,312214.65
2020-10-29,Debit Card,27652.58,0.0,339867.23
2020-10-29,Tax,0.0,48552.46,291314.77
2020-10-29,Cheque,0.0,145657.39,145657.38
2020-10-29,Debit Card,0.0,16184.15,129473.23
2020-10-29,Reversal,0.0,12947.32,116525.91
2020-10-29,Cash,1864732.0,0.0,1981257.91
2020-10-29,Cash,0.0,990628.96,990628.96
2020-10-29,Interest,0.0,110069.88,880559.08
2020-10-29,Tax,0.0,293519.69,587039.39
2020-10-30,NEFT,0.0,65226.6,521812.79
2020-10-30,Debit Card,0.0,74544.68,447268.11
2020-10-30,Interest,2679.8,0.0,449947.91
2020-10-30,NEFT,0.0,64278.27,385669.64
2020-10-30,Bill,1656865.8,0.0,2042535.44
2020-10-30,Bill,92824.9,0.0,2135360.34
2020-10-30,Purchase,1309383.25,0.0,3444743.59
2020-10-30,ATM,0.0,1722371.8,1722371.8
2020-10-30,ATM,0.0,215296.48,1507075.32
2020-10-30,Tax,1526978.5,0.0,3034053.82
2020-10-30,Reversal,0.0,337117.09,2696936.73
2020-10-30,Cheque,56.0,0.0,2696992.73
2020-10-30,Miscellaneous,1135.0,0.0,2698127.73
2020-10-30,ATM,0.0,674531.93,2023595.8
2020-10-30,ATM,4.1,0.0,2023599.9
2020-10-30,ATM,508999.0,0.0,2532598.9
2020-10-30,Cash,0.0,422099.82,2110499.08
2020-10-30,Cash,4.4,0.0,2110503.48
2020-10-30,Cash,159.0,0.0,2110662.48
2020-10-30,ATM,60.0,0.0,2110722.48
2020-10-30,ATM,0.0,2110722.48,0.0
2020-10-30,RTGS,6.62,0.0,6.62
2020-10-30,NEFT,1926.0,0.0,1932.62
2020-10-30,ATM,0.0,276.09,1656.53
2020-10-30,Cash,0.0,414.13,1242.4
2020-10-30,Debit Card,1732.47,0.0,2974.87
2020-10-30,Tax,1.1,0.0,2975.97
2020-10-30,Commission,0.0,496.0,2479.98
2020-10-31,IMPS,1868.8,0.0,4348.78
2020-10-31,Transfer,1592073.5,0.0,1596422.28
2020-10-31,Purchase,1.35,0.0,1596423.63
2020-10-31,Debit Card,169350.38,0.0,1765774.01
2020-11-01,Commission,26815.61,0.0,1792589.62
2020-11-01,Debit Card,0.0,179258.96,1613330.66
2020-11-01,Transfer,0.0,201666.33,1411664.33
2020-11-01,RTGS,0.0,235277.39,1176386.94
2020-11-01,Tax,130599.2,0.0,1306986.14
2020-11-01,Purchase,0.0,326746.54,980239.6
2020-11-01,Debit Card,108107.9,0.0,1088347.5
2020-11-01,Transfer,6.14,0.0,1088353.64
2020-11-01,RTGS,0.0,120928.18,967425.46
2020-11-01,Interest,0.0,967425.46,0.0
2020-11-01,ATM,47.32,0.0,47.32
2020-11-01,Miscellaneous,453428.0,0.0,453475.32
2020-11-01,Tax,215608.0,0.0,669083.32
2020-11-01,Debit Card,5406.8,0.0,674490.12
2020-11-01,IMPS,0.0,134898.02,539592.1
2020-11-01,ATM,6.0,0.0,539598.1
2020-11-01,Purchase,3.1,0.0,539601.2
2020-11-01,Tax,189438.06,0.0,729039.26
2020-11-01,Debit Card,15.66,0.0,729054.92
2020-11-01,Cheque,0.0,72905.49,656149.43
2020-11-01,Debit Card,0.0,82018.68,574130.75
2020-11-01,Debit Card,0.0,63792.31,510338.44
2020-11-01,Commission,398.8,0.0,510737.24
2020-11-01,Cash,0.0,56748.58,453988.66
2020-11-01,Cash,444.1,0.0,454432.76
2020-11-01,Reversal,0.0,113608.19,340824.57
2020-11-01,Cheque,196301.8,0.0,537126.37
2020-11-01,ATM,0.0,134281.59,402844.78
2020-11-01,Cheque,0.0,201422.39,201422.39
2020-11-01,Cheque,0.0,40284.48,161137.91
2020-11-01,NEFT,113.2,0.0,161251.11
2020-11-02,IMPS,0.6,0.0,161251.71
2020-11-02,Tax,0.0,17916.86,143334.85
2020-11-02,Cash,172451.56,0.0,315786.41
2020-11-03,IMPS,1150.0,0.0,316936.41
2020-11-03,Commission,20.38,0.0,316956.79
2020-11-03,Interest,705106.0,0.0,1022062.79
2020-11-03,Tax,5.6,0.0,1022068.39
2020-11-03,Reversal,0.0,340689.46,681378.93
2020-11-03,ATM,0.0,340689.47,340689.46
2020-11-04,IMPS,0.0,340689.46,0.0
2020-11-04,Commission,95022.3,0.0,95022.3
2020-11-04,Commission,8630.91,0.0,103653.21
2020-11-04,Purchase,262156.0,0.0,365809.21
2020-11-04,Bill,350.8,0.0,366160.01
2020-11-04,Transfer,178.9,0.0,366338.91
2020-11-04,Reversal,187267.7,0.0,553606.61
2020-11-04,Cash,1671159.0,0.0,2224765.61
2020-11-04,Cash,0.0,317823.66,1906941.95
2020-11-04,Tax,0.0,272420.28,1634521.67
2020-11-04,NEFT,299.0,0.0,1634820.67
2020-11-04,RTGS,8.92,0.0,1634829.59
2020-11-04,RTGS,468.0,0.0,1635297.59
2020-11-04,IMPS,477.32,0.0,1635774.91
2020-11-04,Miscellaneous,30339.05,0.0,1666113.96
2020-11-04,Cash,45.0,0.0,1666158.96
2020-11-04,IMPS,0.0,1666158.96,0.0
2020-11-04,Miscellaneous,3166.8,0.0,3166.8
2020-11-04,Cheque,12348.0,0.0,15514.8
2020-11-05,Commission,7727.0,0.0,23241.8
2020-11-05,IMPS,0.0,2324.18,20917.62
2020-11-05,IMPS,26726.9,0.0,47644.52
2020-11-05,Commission,0.0,6806.36,40838.16
2020-11-05,Debit Card,2.0,0.0,40840.16
2020-11-05,Interest,4.83,0.0,40844.99
2020-11-05,Commission,0.0,8169.0,32675.99
2020-11-05,Purchase,0.2,0.0,32676.19
2020-11-05,Transfer,1496046.0,0.0,1528722.19
2020-11-05,Purchase,0.0,1528722.19,0.0
2020-11-05,Tax,60313.94,0.0,60313.94
2020-11-05,Purchase,0.0,6701.55,53612.39
2020-11-06,Tax,510.6,0.0,54122.99
2020-11-06,RTGS,1195.68,0.0,55318.67
2020-11-06,Bill,1934.0,0.0,57252.67
2020-11-06,Cash,47946.28,0.0,105198.95
2020-11-06,Interest,11764.0,0.0,116962.95
2020-11-06,RTGS,0.0,16708.99,100253.96
2020-11-06,Cash,21497.59,0.0,121751.55
2020-11-06,Purchase,0.0,12175.16,109576.4
2020-11-06,RTGS,3900.9,0.0,113477.3
2020-11-06,Commission,0.0,56738.65,56738.65
2020-11-06,Debit Card,0.0,5673.87,51064.78
2020-11-06,Tax,368.0,0.0,51432.78
2020-11-06,Debit Card,12593.4,0.0,64026.18
2020-11-06,Miscellaneous,0.0,16006.55,48019.64
2020-11-06,Reversal,0.0,5335.52,42684.12
2020-11-06,IMPS,2.0,0.0,42686.12
2020-11-06,Transfer,0.0,14228.71,28457.41
2020-11-06,Miscellaneous,0.0,4742.9,23714.51
2020-11-06,ATM,1241.98,0.0,24956.49
2020-11-06,Cash,6.0,0.0,24962.49
2020-11-06,IMPS,0.0,4992.5,19969.99
2020-11-06,Miscellaneous,0.0,6656.66,13313.33
2020-11-06,Bill,0.0,1664.17,11649.16
2020-11-06,Interest,0.0,1664.17,9984.99
2020-11-06,Debit Card,319.0,0.0,10303.99
2020-11-06,Tax,0.0,1030.4,9273.59
2020-11-06,Transfer,2071.2,0.0,11344.79
2020-11-06,NEFT,47.0,0.0,11391.79
2020-11-06,Commission,0.0,2278.36,9113.43
2020-11-06,Commission,3.0,0.0,9116.43
2020-11-07,IMPS,0.0,1519.41,7597.02
2020-11-08,Reversal,0.0,7597.02,0.0
2020-11-08,Debit Card,345.0,0.0,345.0
2020-11-09,Interest,7861.82,0.0,8206.82
2020-11-09,Miscellaneous,0.0,4103.41,4103.41
2020-11-09,Interest,0.0,1367.8,2735.61
2020-11-09,NEFT,5.0,0.0,2740.61
2020-11-09,Transfer,0.0,685.15,2055.46
2020-11-09,ATM,0.0,228.38,1827.08
2020-11-09,Transfer,228586.0,0.0,230413.08
2020-11-09,Debit Card,13.7,0.0,230426.78
2020-11-09,RTGS,0.0,38404.46,192022.32
2020-11-09,Interest,2250.49,0.0,194272.81
2020-11-09,Miscellaneous,6137.25,0.0,200410.06
2020-11-09,Commission,201.0,0.0,200611.06
2020-11-09,NEFT,407.8,0.0,201018.86
2020-11-09,Cash,0.0,67006.29,134012.57
2020-11-09,Interest,0.0,26802.51,107210.06
2020-11-09,Miscellaneous,8.0,0.0,107218.06
2020-11-09,Cheque,0.0,107218.06,0.0
2020-11-09,IMPS,3017.0,0.0,3017.0
2020-11-09,Miscellaneous,0.0,431.0,2586.0
2020-11-09,Purchase,2.7,0.0,2588.7
2020-11-09,Bill,0.0,369.81,2218.89
2020-11-09,Bill,3524.21,0.0,5743.1
2020-11-09,Miscellaneous,0.0,717.89,5025.21
2020-11-09,NEFT,0.0,2512.61,2512.6
2020-11-09,ATM,0.0,418.77,2093.83
2020-11-09,Commission,72645.0,0.0,74738.83
2020-11-09,NEFT,40851.5,0.0,115590.33
2020-11-09,Miscellaneous,0.0,23118.07,92472.26
2020-11-09,IMPS,0.0,46236.13,46236.13
2020-11-09,RTGS,0.0,5137.35,41098.78
2020-11-09,Bill,0.0,6849.8,34248.98
2020-11-09,NEFT,0.0,17124.49,17124.49
2020-11-09,Reversal,339.0,0.0,17463.49
2020-11-09,Purchase,55418.5,0.0,72881.99
2020-11-09,Bill,0.0,24294.0,48587.99
2020-11-09,Reversal,0.0,5398.67,43189.32
2020-11-09,Miscellaneous,1420831.8,0.0,1464021.12
2020-11-09,Cheque,0.0,209145.87,1254875.25
2020-11-09,Cheque,19.8,0.0,1254895.05
2020-11-09,NEFT,394.0,0.0,1255289.05
2020-11-09,Debit Card,0.0,209214.84,1046074.21
2020-11-09,IMPS,0.72,0.0,1046074.93
2020-11-09,Miscellaneous,3026.45,0.0,1049101.38
2020-11-09,ATM,0.0,104910.14,944191.24
2020-11-09,Debit Card,4076.57,0.0,948267.81
2020-11-09,Interest,0.0,948267.81,0.0
2020-11-09,Miscellaneous,895883.0,0.0,895883.0
2020-11-09,Miscellaneous,0.0,895883.0,0.0
2020-11-09,IMPS,273.6,0.0,273.6
2020-11-09,Cheque,421.5,0.0,695.1
2020-11-09,IMPS,452.6,0.0,1147.7
2020-11-09,Debit Card,108416.0,0.0,109563.7
2020-11-09,Cheque,0.0,0.0,109563.7
2020-11-09,Cheque,0.0,0.0,109563.7
2020-11-09,Cheque,0.0,15651.96,93911.74
2020-11-09,Cheque,0.0,31303.91,62607.83
2020-11-10,ATM,726.0,0.0,63333.83
2020-11-10,Reversal,0.0,7037.09,56296.74
2020-11-10,Cash,988.8,0.0,57285.54
2020-11-10,NEFT,1.8,0.0,57287.34
2020-11-10,Reversal,4043.35,0.0,61330.69
2020-11-10,Interest,0.0,7666.34,53664.35
2020-11-10,RTGS,0.0,26832.18,26832.18
2020-11-10,Reversal,0.0,2683.22,24148.96
2020-11-10,Purchase,19.64,0.0,24168.6
2020-11-10,ATM,0.0,2416.86,21751.74
2020-11-10,Interest,0.0,2416.86,19334.88
2020-11-10,NEFT,1074028.0,0.0,1093362.88
2020-11-10,Cheque,649527.8,0.0,1742890.68
2020-11-10,Commission,0.0,193654.52,1549236.16
2020-11-10,RTGS,63.0,0.0,1549299.16
2020-11-10,Purchase,0.0,154929.92,1394369.24
2020-11-10,Bill,8.0,0.0,1394377.24
2020-11-10,Tax,0.0,348594.31,1045782.93
2020-11-10,IMPS,0.0,522891.47,522891.46
2020-11-10,Cheque,0.0,74698.78,448192.68
2020-11-10,RTGS,0.0,64027.53,384165.15
2020-11-10,Tax,28074.1,0.0,412239.25
2020-11-10,Interest,0.0,51529.91,360709.34
2020-11-10,Commission,0.0,120236.45,240472.89
2020-11-10,Bill,0.0,40078.82,200394.08
2020-11-10,ATM,0.0,50098.52,150295.56
2020-11-10,Cash,3078.0,0.0,153373.56
2020-11-10,Transfer,0.0,30674.71,122698.85
2020-11-10,Cheque,0.83,0.0,122699.68
2020-11-10,Interest,0.0,13633.3,109066.38
2020-11-10,Miscellaneous,140.4,0.0,109206.78
2020-11-10,RTGS,635.6,0.0,109842.38
2020-11-10,IMPS,5.0,0.0,109847.38
2020-11-10,Cheque,15643.0,0.0,125490.38
2020-11-10,IMPS,0.0,62745.19,62745.19
2020-11-10,Cash,5.36,0.0,62750.55
2020-11-11,Cheque,0.0,7843.82,54906.73
2020-11-11,Miscellaneous,0.0,27453.37,27453.36
2020-11-11,NEFT,0.0,5490.67,21962.69
2020-11-11,Tax,489721.0,0.0,511683.69
2020-11-11,Bill,0.0,51168.37,460515.32
2020-11-11,Purchase,0.0,65787.9,394727.42
2020-11-11,Reversal,0.0,43858.6,350868.82
2020-11-11,ATM,143368.5,0.0,494237.32
2020-11-11,Debit Card,19535.8,0.0,513773.12
2020-11-11,ATM,0.82,0.0,513773.94
2020-11-11,Transfer,2674.04,0.0,516447.98
2020-11-11,Interest,69157.9,0.0,585605.88
2020-11-11,Purchase,5.0,0.0,585610.88
2020-11-11,Cash,35.13,0.0,585646.01
2020-11-11,Miscellaneous,0.0,585646.01,0.0
2020-11-11,ATM,31.4,0.0,31.4
2020-11-11,Reversal,42.1,0.0,73.5
2020-11-11,Commission,0.0,14.7,58.8
2020-11-11,Interest,0.0,14.7,44.1
2020-11-11,NEFT,0.0,14.7,29.4
2020-11-11,Bill,61.42,0.0,90.82
2020-11-11,Purchase,0.0,9.08,81.74
2020-11-11,Commission,2440.0,0.0,2521.74
2020-11-11,Interest,0.0,1260.87,1260.87
2020-11-11,IMPS,1297628.0,0.0,1298888.87
2020-11-11,Cash,2.0,0.0,1298890.87
2020-11-11,NEFT,0.0,432963.62,865927.25
2020-11-11,Debit Card,308.0,0.0,866235.25
2020-11-11,IMPS,0.0,144372.54,721862.71
2020-11-11,Cheque,252645.56,0.0,974508.27
2020-11-11,Commission,0.0,487254.14,487254.14
2020-11-11,ATM,257.63,0.0,487511.77
2020-11-11,Reversal,0.0,487511.77,0.0
2020-11-11,Commission,1499015.5,0.0,1499015.5
2020-11-11,Interest,792455.0,0.0,2291470.5
2020-11-11,RTGS,0.0,286433.81,2005036.69
2020-11-11,Tax,562644.75,0.0,2567681.44
2020-11-11,RTGS,0.0,256768.14,2310913.3
2020-11-11,Interest,0.0,231091.33,2079821.97
2020-11-11,RTGS,336.0,0.0,2080157.97
2020-11-11,Reversal,0.0,346693.0,1733464.98
2020-11-11,Reversal,70755.7,0.0,1804220.68
2020-11-11,Cash,122285.25,0.0,1926505.93
2020-11-11,Purchase,16844.1,0.0,1943350.03
2020-11-12,Commission,0.0,971675.02,971675.02
2020-11-12,IMPS,0.0,971675.02,0.0
2020-11-12,Purchase,821424.2,0.0,821424.2
2020-11-12,IMPS,0.0,821424.2,0.0
2020-11-12,Debit Card,5.0,0.0,5.0
2020-11-12,Cheque,177318.0,0.0,177323.0
2020-11-12,Commission,6.15,0.0,177329.15
2020-11-12,Cheque,0.0,17732.92,159596.23
2020-11-12,Transfer,14592.0,0.0,174188.23
2020-11-12,Tax,0.0,29031.37,145156.86
2020-11-12,IMPS,0.0,24192.81,120964.05
2020-11-12,Debit Card,0.0,30241.01,90723.04
2020-11-12,Tax,167.0,0.0,90890.04
2020-11-12,Reversal,7.0,0.0,90897.04
2020-11-12,Reversal,0.0,30299.01,60598.03
2020-11-12,Commission,0.0,15149.51,45448.52
2020-11-12,Transfer,3384.0,0.0,48832.52
2020-11-12,Bill,0.0,48832.52,0.0
2020-11-12,Bill,3691.49,0.0,3691.49
2020-11-12,Cash,0.0,738.3,2953.19
2020-11-12,Commission,0.0,328.13,2625.06
2020-11-12,Cheque,0.0,875.02,1750.04
2020-11-12,Bill,5.0,0.0,1755.04
2020-11-12,Miscellaneous,15.0,0.0,1770.04
2020-11-12,Bill,0.68,0.0,1770.72
2020-11-12,Bill,995802.0,0.0,997572.72
2020-11-12,Debit Card,0.4,0.0,997573.12
2020-11-12,Interest,0.0,166262.19,831310.93
2020-11-12,Transfer,0.0,118758.7,712552.23
2020-11-12,Tax,0.0,712552.23,0.0
2020-11-12,IMPS,61.0,0.0,61.0
2020-11-12,Commission,0.0,12.2,48.8
2020-11-12,Cheque,0.0,16.27,32.53
2020-11-12,NEFT,0.0,3.25,29.28
2020-11-12,Interest,0.0,3.66,25.62
2020-11-12,ATM,0.0,12.81,12.81
2020-11-13,Transfer,1391.0,0.0,1403.81
2020-11-13,Cheque,46033.0,0.0,47436.81
2020-11-13,Tax,1894891.25,0.0,1942328.06
2020-11-13,Miscellaneous,0.0,194232.81,1748095.25
2020-11-13,Tax,3193.0,0.0,1751288.25
2020-11-13,RTGS,2881.0,0.0,1754169.25
2020-11-13,Interest,0.0,438542.31,1315626.94
2020-11-13,Cheque,46.62,0.0,1315673.56
2020-11-13,Reversal,0.0,131567.36,1184106.2
2020-11-13,Interest,0.0,197351.03,986755.17
2020-11-13,Cash,0.0,493377.59,493377.58
2020-11-13,NEFT,33561.38,0.0,526938.96
2020-11-13,Cheque,0.0,263469.48,263469.48
2020-11-13,Purchase,3.7,0.0,263473.18
2020-11-13,Purchase,440.79,0.0,263913.97
2020-11-13,Tax,170.49,0.0,264084.46
2020-11-13,Commission,23468.0,0.0,287552.46
2020-11-13,RTGS,205.0,0.0,287757.46
2020-11-13,Tax,218582.91,0.0,506340.37
2020-11-13,Miscellaneous,15266.0,0.0,521606.37
2020-11-13,Debit Card,509.01,0.0,522115.38
2020-11-13,Interest,134.1,0.0,522249.48
2020-11-13,Interest,0.0,74607.07,447642.41
2020-11-13,Reversal,0.0,223821.21,223821.2
2020-11-13,IMPS,0.0,223821.2,0.0
2020-11-13,IMPS,112.61,0.0,112.61
2020-11-13,Tax,0.0,112.61,0.0
2020-11-13,Debit Card,395.0,0.0,395.0
2020-11-13,Cheque,0.0,43.89,351.11
2020-11-13,Reversal,0.0,58.52,292.59
2020-11-13,RTGS,0.0,29.26,263.33
2020-11-13,Bill,0.0,52.67,210.66
2020-11-13,NEFT,4.5,0.0,215.16
2020-11-13,Tax,0.0,26.9,188.26
2020-11-14,Cheque,237.84,0.0,426.1
2020-11-14,Tax,44.71,0.0,470.81
2020-11-14,NEFT,0.0,58.85,411.96
2020-11-14,Tax,1256.0,0.0,1667.96
2020-11-14,Commission,0.0,833.98,833.98
2020-11-14,Cheque,0.0,833.98,0.0
2020-11-14,Purchase,3.0,0.0,3.0
2020-11-14,Reversal,0.0,0.3,2.7
2020-11-14,Tax,0.0,0.34,2.36
2020-11-14,NEFT,0.0,0.3,2.06
2020-11-14,NEFT,0.0,1.03,1.03
2020-11-14,Purchase,2029620.0,0.0,2029621.03
2020-11-14,ATM,0.0,338270.17,1691350.86
2020-11-14,Reversal,27179.0,0.0,1718529.86
2020-11-14,RTGS,3.8,0.0,1718533.66
2020-11-14,Reversal,0.0,1718533.66,0.0
2020-11-14,Bill,1865295.2,0.0,1865295.2
2020-11-14,Cheque,0.0,932647.6,932647.6
2020-11-14,Transfer,0.0,466323.8,466323.8
2020-11-14,Tax,0.0,116580.95,349742.85
2020-11-14,Cash,0.0,43717.86,306024.99
2020-11-14,Purchase,0.0,30602.5,275422.49
2020-11-14,Bill,0.0,55084.5,220337.99
2020-11-14,Tax,0.0,36723.0,183614.99
2020-11-14,Cheque,0.0,61205.0,122409.99
2020-11-14,RTGS,72977.9,0.0,195387.89
2020-11-14,Tax,20679.54,0.0,216067.43
2020-11-14,Reversal,0.0,30866.78,185200.65
2020-11-14,IMPS,0.0,23150.08,162050.57
2020-11-14,ATM,0.0,18005.62,144044.95
2020-11-14,Bill,0.0,144044.95,0.0
2020-11-15,Purchase,53.0,0.0,53.0
2020-11-15,Interest,0.0,17.67,35.33
2020-11-15,Transfer,0.0,35.33,0.0
2020-11-15,Purchase,4071.1,0.0,4071.1
2020-11-15,Cheque,16598.8,0.0,20669.9
2020-11-15,ATM,44.9,0.0,20714.8
2020-11-15,Cheque,2852.0,0.0,23566.8
2020-11-15,Purchase,26407.47,0.0,49974.27
2020-11-15,Transfer,51.0,0.0,50025.27
2020-11-15,Cash,321.14,0.0,50346.41
2020-11-15,Purchase,0.0,5594.05,44752.36
2020-11-15,IMPS,0.0,4972.48,39779.88
2020-11-15,IMPS,0.0,9944.97,29834.91
2020-11-15,RTGS,7.2,0.0,29842.11
2020-11-15,Bill,5.71,0.0,29847.82
2020-11-15,Tax,0.0,3316.42,26531.4
2020-11-15,Reversal,3378.45,0.0,29909.85
2020-11-15,ATM,4.0,0.0,29913.85
2020-11-15,ATM,29190.0,0.0,59103.85
2020-11-15,Miscellaneous,0.0,6567.09,52536.76
2020-11-15,Debit Card,0.0,17512.25,35024.51
2020-11-15,Commission,0.0,35024.51,0.0
2020-11-15,Purchase,222479.5,0.0,222479.5
2020-11-15,Purchase,3145.89,0.0,225625.39
2020-11-15,NEFT,0.0,32232.2,193393.19
2020-11-15,IMPS,37.25,0.0,193430.44
2020-11-15,Cash,23081.6,0.0,216512.04
2020-11-15,RTGS,0.0,72170.68,144341.36
2020-11-15,Debit Card,0.0,14434.14,129907.22
2020-11-15,ATM,7.4,0.0,129914.62
2020-11-16,Reversal,0.0,12991.46,116923.16
2020-11-16,Reversal,0.0,19487.19,97435.97
2020-11-16,Cash,0.0,97435.97,0.0
2020-11-16,RTGS,227222.41,0.0,227222.41
2020-11-16,Tax,1366813.0,0.0,1594035.41
2020-11-16,IMPS,784448.8,0.0,2378484.21
2020-11-16,NEFT,5.79,0.0,2378490.0
2020-11-17,Commission,0.0,297311.25,2081178.75
2020-11-17,Interest,4.5,0.0,2081183.25
2020-11-17,Bill,0.0,2081183.25,0.0
2020-11-17,Commission,30221.0,0.0,30221.0
2020-11-17,Cash,0.0,4317.29,25903.71
2020-11-17,Reversal,0.0,8634.57,17269.14
2020-11-17,Cheque,5.6,0.0,17274.74
2020-11-17,Tax,0.0,5758.25,11516.49
2020-11-17,Cheque,0.0,1151.65,10364.84
2020-11-17,Commission,3012.0,0.0,13376.84
2020-11-17,Debit Card,320.9,0.0,13697.74
2020-11-18,IMPS,36.08,0.0,13733.82
2020-11-18,ATM,25.98,0.0,13759.8
2020-11-18,Cheque,0.0,13759.8,0.0
2020-11-18,Interest,179277.0,0.0,179277.0
2020-11-18,Commission,0.0,44819.25,134457.75
2020-11-18,Interest,0.0,67228.88,67228.88
2020-11-18,Bill,0.0,11204.81,56024.07
2020-11-18,Miscellaneous,4.98,0.0,56029.05
2020-11-18,Transfer,3.0,0.0,56032.05
2020-11-18,ATM,0.0,11206.41,44825.64
2020-11-19,Interest,0.0,5603.21,39222.44
2020-11-19,IMPS,4.9,0.0,39227.34
2020-11-19,IMPS,0.0,19613.67,19613.67
2020-11-19,Tax,71.6,0.0,19685.27
2020-11-19,ATM,272.55,0.0,19957.82
2020-11-19,Tax,0.0,2494.73,17463.09
2020-11-20,Cheque,0.0,5821.03,11642.06
2020-11-20,Transfer,0.0,3880.69,7761.37
2020-11-20,Cash,19451.83,0.0,27213.2
2020-11-20,NEFT,0.0,3887.6,23325.6
2020-11-20,Debit Card,2.34,0.0,23327.94
2020-11-20,ATM,0.0,11663.97,11663.97
2020-11-20,Reversal,0.0,3887.99,7775.98
2020-11-20,RTGS,2088811.8,0.0,2096587.78
2020-11-20,Debit Card,2.7,0.0,2096590.48
2020-11-20,IMPS,0.0,349431.75,1747158.73
2020-11-20,Miscellaneous,45.0,0.0,1747203.73
2020-11-21,NEFT,5.04,0.0,1747208.77
2020-11-21,Cash,0.0,291201.46,1456007.31
2020-11-21,Tax,262.75,0.0,1456270.06
2020-11-21,Cheque,0.0,208038.58,1248231.48
2020-11-21,Purchase,2143.72,0.0,1250375.2
2020-11-21,Transfer,4043.8,0.0,1254419.0
2020-11-21,Cash,0.0,313604.75,940814.25
2020-11-21,Cash,0.0,134402.04,806412.21
2020-11-21,Cheque,0.0,134402.04,672010.18
2020-11-21,Purchase,4.38,0.0,672014.56
2020-11-21,Reversal,0.0,67201.46,604813.1
2020-11-21,RTGS,0.0,67201.46,537611.64
2020-11-21,RTGS,1663480.0,0.0,2201091.64
2020-11-21,Bill,0.0,366848.61,1834243.03
2020-11-22,Cash,0.99,0.0,1834244.02
2020-11-22,NEFT,20.0,0.0,1834264.02
2020-11-22,Miscellaneous,90437.3,0.0,1924701.32
2020-11-22,ATM,0.0,962350.66,962350.66
2020-11-22,Tax,772.0,0.0,963122.66
2020-11-22,Cheque,0.0,192624.53,770498.13
2020-11-22,Reversal,0.0,128416.36,642081.78
2020-11-22,IMPS,289.3,0.0,642371.08
2020-11-22,Transfer,499.7,0.0,642870.78
2020-11-22,Transfer,0.0,91838.68,551032.1
2020-11-22,ATM,902256.8,0.0,1453288.9
2020-11-22,Cash,197432.0,0.0,1650720.9
2020-11-22,NEFT,2099.07,0.0,1652819.97
2020-11-22,ATM,229747.0,0.0,1882566.97
2020-11-22,Reversal,0.0,268938.14,1613628.83
2020-11-22,Interest,3721.0,0.0,1617349.83
2020-11-22,Transfer,5.2,0.0,1617355.03
2020-11-22,Purchase,0.0,161735.5,1455619.53
2020-11-22,Purchase,0.0,363904.88,1091714.65
2020-11-22,ATM,29862.0,0.0,1121576.65
2020-11-22,Debit Card,8506.19,0.0,1130082.84
2020-11-22,ATM,0.0,565041.42,565041.42
2020-11-22,Interest,0.0,188347.14,376694.28
2020-11-22,Purchase,221597.9,0.0,598292.18
2020-11-22,RTGS,8.29,0.0,598300.47
2020-11-22,Miscellaneous,3340.0,0.0,601640.47
2020-11-22,Interest,1945724.8,0.0,2547365.27
2020-11-22,Transfer,0.0,509473.05,2037892.22
2020-11-22,Transfer,17454.0,0.0,2055346.22
2020-11-22,Reversal,0.0,342557.7,1712788.52
2020-11-22,Miscellaneous,1044.0,0.0,1713832.52
2020-11-22,Commission,0.0,190425.84,1523406.68
2020-11-22,Interest,38.1,0.0,1523444.78
2020-11-22,Tax,32639.73,0.0,1556084.51
2020-11-22,Cheque,0.0,518694.84,1037389.67
2020-11-22,Bill,5.0,0.0,1037394.67
2020-11-23,Commission,0.0,115266.07,922128.6
2020-11-23,ATM,659066.0,0.0,1581194.6
2020-11-23,ATM,257.0,0.0,1581451.6
2020-11-23,Reversal,0.0,225921.66,1355529.94
2020-11-23,IMPS,0.0,135552.99,1219976.95
2020-11-23,ATM,0.0,203329.49,1016647.46
2020-11-23,Reversal,158929.09,0.0,1175576.55
2020-11-23,Commission,163331.0,0.0,1338907.55
2020-11-24,Interest,2691.0,0.0,1341598.55
2020-11-24,Cash,0.0,447199.52,894399.03
2020-11-24,Bill,0.0,127771.29,766627.74
2020-11-24,NEFT,0.0,255542.58,511085.16
2020-11-24,Debit Card,0.0,56787.24,454297.92
2020-11-24,Cash,389.24,0.0,454687.16
2020-11-24,Tax,0.0,64955.31,389731.85
2020-11-24,Commission,0.0,194865.93,194865.92
2020-11-24,ATM,3949.0,0.0,198814.92
2020-11-24,Miscellaneous,0.0,99407.46,99407.46
2020-11-24,Cash,23142.5,0.0,122549.96
2020-11-24,Interest,7.1,0.0,122557.06
2020-11-24,ATM,14545.11,0.0,137102.17
2020-11-24,RTGS,0.0,68551.09,68551.09
2020-11-24,Purchase,0.0,68551.09,0.0
2020-11-24,Transfer,499.1,0.0,499.1
2020-11-24,Miscellaneous,0.0,124.78,374.33
2020-11-24,Bill,997.9,0.0,1372.23
2020-11-24,Cheque,6.0,0.0,1378.23
2020-11-24,Cash,262075.69,0.0,263453.92
2020-11-24,Reversal,468.65,0.0,263922.57
2020-11-24,Tax,306.11,0.0,264228.68
2020-11-24,RTGS,0.0,264228.68,0.0
2020-11-24,Debit Card,588056.5,0.0,588056.5
2020-11-24,Miscellaneous,50.2,0.0,588106.7
2020-11-24,IMPS,0.0,58810.67,529296.03
2020-11-24,Cash,16548.71,0.0,545844.74
2020-11-24,RTGS,1384.0,0.0,547228.74
2020-11-24,Interest,6.0,0.0,547234.74
2020-11-24,Interest,0.0,547234.74,0.0
2020-11-24,Miscellaneous,451.04,0.0,451.04
2020-11-24,Cheque,12985.73,0.0,13436.77
2020-11-24,NEFT,675670.0,0.0,689106.77
2020-11-24,IMPS,0.0,68910.68,620196.09
2020-11-24,Cash,29714.8,0.0,649910.89
2020-11-24,Purchase,0.0,72212.32,577698.57
2020-11-24,Purchase,3427.1,0.0,581125.67
2020-11-24,IMPS,3492.8,0.0,584618.47
2020-11-24,Purchase,0.0,292309.24,292309.24
2020-11-24,Miscellaneous,1946180.5,0.0,2238489.74
2020-11-24,Purchase,0.0,559622.44,1678867.31
2020-11-24,Debit Card,0.0,839433.66,839433.66
2020-11-24,NEFT,3.94,0.0,839437.6
2020-11-24,IMPS,7.0,0.0,839444.6
2020-11-24,Cash,0.0,839444.6,0.0
2020-11-24,Tax,17214.0,0.0,17214.0
2020-11-24,Debit Card,0.0,2459.14,14754.86
2020-11-24,NEFT,0.0,1844.36,12910.5
2020-11-24,IMPS,19147.0,0.0,32057.5
2020-11-24,Cash,0.0,4007.19,28050.31
2020-11-24,Bill,0.0,3506.29,24544.02
2020-11-24,Cheque,25076.8,0.0,49620.82
2020-11-24,Tax,46.3,0.0,49667.12
2020-11-24,Debit Card,55.6,0.0,49722.72
2020-11-24,Miscellaneous,260.65,0.0,49983.37
2020-11-24,Bill,0.0,4998.34,44985.03
2020-11-24,Tax,0.0,4998.34,39986.69
2020-11-24,ATM,0.0,19993.35,19993.34
2020-11-24,ATM,0.0,6664.45,13328.89
2020-11-24,Commission,657739.5,0.0,671068.39
2020-11-24,Reversal,2.73,0.0,671071.12
2020-11-24,IMPS,242634.6,0.0,913705.72
2020-11-24,NEFT,0.0,913705.72,0.0
2020-11-24,Miscellaneous,421.0,0.0,421.0
2020-11-24,Interest,8447.72,0.0,8868.72
2020-11-24,Tax,0.0,886.87,7981.85
2020-11-24,Miscellaneous,6.1,0.0,7987.95
2020-11-24,NEFT,0.0,1597.59,6390.36
2020-11-24,Reversal,0.0,912.91,5477.45
2020-11-24,Transfer,0.0,547.75,4929.7
2020-11-24,Interest,0.0,616.21,4313.49
2020-11-24,RTGS,0.0,4313.49,0.0
2020-11-24,Miscellaneous,15.8,0.0,15.8
2020-11-24,IMPS,81.91,0.0,97.71
2020-11-24,ATM,0.0,19.54,78.17
2020-11-25,Debit Card,2158.0,0.0,2236.17
2020-11-25,Interest,0.0,279.52,1956.65
2020-11-25,Cash,0.0,279.52,1677.13
2020-11-25,IMPS,16171.07,0.0,17848.2
2020-11-25,Purchase,33.0,0.0,17881.2
2020-11-25,Cheque,0.0,3576.24,14304.96
2020-11-25,Transfer,233905.5,0.0,248210.46
2020-11-25,Cash,0.0,35458.64,212751.82
2020-11-25,Purchase,462.3,0.0,213214.12
2020-11-25,Interest,202420.0,0.0,415634.12
2020-11-25,Commission,0.0,69272.35,346361.77
2020-11-25,Debit Card,0.0,86590.44,259771.33
2020-11-26,Commission,0.0,86590.44,173180.89
2020-11-27,Miscellaneous,0.0,21647.61,151533.28
2020-11-27,Purchase,0.0,25255.55,126277.73
2020-11-27,IMPS,0.0,21046.29,105231.44
2020-11-27,Interest,0.0,26307.86,78923.58
2020-11-28,Purchase,82760.4,0.0,161683.98
2020-11-28,Commission,0.0,17964.89,143719.09
2020-11-28,RTGS,371.8,0.0,144090.89
2020-11-28,NEFT,21388.0,0.0,165478.89
2020-11-28,Reversal,0.0,55159.63,110319.26
2020-11-28,ATM,459.94,0.0,110779.2
2020-11-28,Cheque,0.0,11077.92,99701.28
2020-11-28,NEFT,54.12,0.0,99755.4
2020-11-28,Miscellaneous,492.71,0.0,100248.11
2020-11-28,NEFT,0.0,10024.81,90223.3
2020-11-28,Debit Card,2886.0,0.0,93109.3
2020-11-28,Transfer,0.0,23277.33,69831.98
2020-11-28,ATM,1332.5,0.0,71164.48
2020-11-28,Purchase,388.0,0.0,71552.48
2020-11-28,Commission,53661.22,0.0,125213.7
2020-11-28,Reversal,0.0,17887.67,107326.03
2020-11-28,Miscellaneous,0.0,53663.02,53663.02
2020-11-28,NEFT,82.44,0.0,53745.46
2020-11-28,Reversal,2.37,0.0,53747.83
2020-11-28,Purchase,40.0,0.0,53787.83
2020-11-28,Interest,1434578.2,0.0,1488366.03
2020-11-28,Debit Card,0.0,372091.51,1116274.52
2020-11-28,Cheque,2705.0,0.0,1118979.52
2020-11-28,Tax,0.0,559489.76,559489.76
2020-11-28,Miscellaneous,0.0,62165.53,497324.23
2020-11-28,NEFT,26.68,0.0,497350.91
2020-11-28,Commission,0.0,99470.18,397880.73
2020-11-28,RTGS,0.0,397880.73,0.0
2020-11-28,IMPS,46375.03,0.0,46375.03
2020-11-28,Debit Card,0.0,46375.03,0.0
2020-11-28,Bill,88181.8,0.0,88181.8
2020-11-28,Miscellaneous,6352.0,0.0,94533.8
2020-11-28,Purchase,15319.4,0.0,109853.2
2020-11-28,Commission,0.0,13731.65,96121.55
2020-11-28,RTGS,0.0,12015.19,84106.36
2020-11-28,Tax,40.7,0.0,84147.06
2020-11-28,IMPS,0.0,8414.71,75732.35
2020-11-28,Tax,2168.0,0.0,77900.35
2020-11-28,RTGS,0.0,25966.78,51933.57
2020-11-28,ATM,0.0,7419.08,44514.49
2020-11-28,RTGS,0.0,4451.45,40063.04
2020-11-28,Interest,12909.0,0.0,52972.04
2020-11-28,Cash,0.0,5297.2,47674.84
2020-11-28,RTGS,0.0,11918.71,35756.13
2020-11-28,Transfer,11854.07,0.0,47610.2
2020-11-28,NEFT,3046.14,0.0,50656.34
2020-11-28,Miscellaneous,322.88,0.0,50979.22
2020-11-28,NEFT,237045.0,0.0,288024.22
2020-11-28,Reversal,897.33,0.0,288921.55
2020-11-28,ATM,486.93,0.0,289408.48
2020-11-28,RTGS,420.93,0.0,289829.41
2020-11-28,Cheque,44404.0,0.0,334233.41
2020-11-28,Debit Card,2530.0,0.0,336763.41
2020-11-28,Bill,0.0,37418.16,299345.25
2020-11-29,Cash,0.0,59869.05,239476.2
2020-11-29,ATM,151.0,0.0,239627.2
2020-11-29,Transfer,0.0,39937.87,199689.33
2020-11-29,RTGS,50981.0,0.0,250670.33
2020-11-30,Commission,0.0,62667.58,188002.75
2020-11-30,IMPS,0.0,188002.75,0.0
2020-11-30,Interest,8.0,0.0,8.0
2020-11-30,Interest,0.0,2.67,5.33
2020-11-30,Interest,0.0,0.89,4.44
2020-11-30,ATM,0.0,0.74,3.7
2020-11-30,Purchase,17893.8,0.0,17897.5
2020-11-30,ATM,43835.62,0.0,61733.12
2020-11-30,Reversal,0.0,6173.31,55559.81
2020-11-30,Transfer,136953.8,0.0,192513.61
2020-11-30,Reversal,0.0,96256.81,96256.8
2020-11-30,Commission,0.0,13750.97,82505.83
2020-11-30,Miscellaneous,213538.5,0.0,296044.33
2020-11-30,Miscellaneous,1670633.5,0.0,1966677.83
2020-11-30,ATM,441.0,0.0,1967118.83
2020-11-30,NEFT,1.3,0.0,1967120.13
2020-11-30,NEFT,0.0,983560.07,983560.06
2020-11-30,Cash,0.0,983560.06,0.0
2020-11-30,Debit Card,0.85,0.0,0.85
2020-11-30,Cash,28412.47,0.0,28413.32
2020-11-30,NEFT,1788.0,0.0,30201.32
2020-11-30,Cheque,0.0,15100.66,15100.66
2020-11-30,Debit Card,1137215.25,0.0,1152315.91
2020-12-01,Interest,0.0,144039.49,1008276.42
2020-12-01,Reversal,0.0,112030.71,896245.71
2020-12-01,Reversal,0.0,149374.29,746871.42
2020-12-01,Debit Card,11988.0,0.0,758859.42
2020-12-01,Debit Card,0.0,379429.71,379429.71
2020-12-01,ATM,0.0,42158.86,337270.85
2020-12-01,Interest,0.0,337270.85,0.0
2020-12-01,Tax,436.15,0.0,436.15
2020-12-01,Transfer,0.0,62.31,373.84
2020-12-01,Commission,0.0,37.38,336.46
2020-12-01,Debit Card,0.0,336.46,0.0
2020-12-01,Commission,223693.03,0.0,223693.03
2020-12-01,Cheque,0.0,22369.3,201323.73
2020-12-01,Purchase,53.83,0.0,201377.56
2020-12-01,NEFT,0.0,50344.39,151033.17
2020-12-01,IMPS,0.0,37758.29,113274.88
2020-12-01,Tax,251831.0,0.0,365105.88
2020-12-01,Purchase,0.0,36510.59,328595.29
2020-12-01,Transfer,0.5,0.0,328595.79
2020-12-01,Cash,0.0,41074.47,287521.32
2020-12-01,Cash,57.07,0.0,287578.39
2020-12-01,ATM,17.44,0.0,287595.83
2020-12-01,Cheque,0.0,31955.09,255640.74
2020-12-01,Miscellaneous,0.0,36520.11,219120.63
2020-12-01,Bill,0.0,21912.06,197208.57
2020-12-01,Bill,202.9,0.0,197411.47
2020-12-01,Interest,0.0,197411.47,0.0
2020-12-01,IMPS,80918.53,0.0,80918.53
2020-12-01,Tax,0.0,8990.95,71927.58
2020-12-01,Bill,780337.8,0.0,852265.38
2020-12-01,Cheque,649.0,0.0,852914.38
2020-12-01,Bill,0.0,85291.44,767622.94
2020-12-01,Commission,472737.0,0.0,1240359.94
2020-12-01,Reversal,23.2,0.0,1240383.14
2020-12-01,Tax,0.0,124038.31,1116344.83
2020-12-01,IMPS,629146.2,0.0,1745491.03
2020-12-01,RTGS,192748.0,0.0,1938239.03
2020-12-01,Debit Card,2413.0,0.0,1940652.03
2020-12-01,ATM,45629.7,0.0,1986281.73
2020-12-01,Tax,93567.7,0.0,2079849.43
2020-12-01,Interest,0.0,346641.57,1733207.86
2020-12-01,Bill,10986.75,0.0,1744194.61
2020-12-01,Bill,0.0,193799.4,1550395.21
2020-12-01,NEFT,0.0,258399.2,1291996.01
2020-12-01,Miscellaneous,0.0,129199.6,1162796.41
2020-12-01,Bill,0.0,166113.77,996682.64
2020-12-01,Reversal,1.0,0.0,996683.64
2020-12-01,Tax,0.0,199336.73,797346.91
2020-12-01,Transfer,0.0,88594.1,708752.81
2020-12-01,Debit Card,1258801.0,0.0,1967553.81
2020-12-01,IMPS,0.0,1967553.81,0.0
2020-12-01,RTGS,510694.0,0.0,510694.0
2020-12-01,ATM,0.0,255347.0,255347.0
2020-12-01,Cheque,886595.75,0.0,1141942.75
2020-12-01,RTGS,192915.19,0.0,1334857.94
2020-12-01,Cash,0.0,1334857.94,0.0
2020-12-01,Cash,152216.38,0.0,152216.38
2020-12-01,Transfer,0.0,30443.28,121773.1
2020-12-01,Cheque,0.0,60886.55,60886.55
2020-12-01,IMPS,368.21,0.0,61254.76
2020-12-01,Interest,0.0,10209.13,51045.63
2020-12-01,Tax,768.6,0.0,51814.23
2020-12-01,Miscellaneous,1452.0,0.0,53266.23
2020-12-01,Transfer,0.0,53266.23,0.0
2020-12-01,Cheque,2.0,0.0,2.0
2020-12-01,NEFT,124.1,0.0,126.1
2020-12-02,NEFT,7.21,0.0,133.31
2020-12-02,Purchase,1320498.25,0.0,1320631.56
2020-12-02,Cash,3.0,0.0,1320634.56
2020-12-02,Transfer,0.0,330158.64,990475.92
2020-12-02,NEFT,0.0,198095.18,792380.74
2020-12-02,Interest,0.0,88042.3,704338.44
2020-12-02,Cash,2215.0,0.0,706553.44
2020-12-02,Miscellaneous,0.0,353276.72,353276.72
2020-12-02,Purchase,255728.0,0.0,609004.72
2020-12-02,Transfer,0.0,67667.19,541337.53
2020-12-02,Transfer,0.0,54133.75,487203.78
2020-12-02,Reversal,0.0,69600.54,417603.24
2020-12-02,Interest,0.0,59657.61,357945.63
2020-12-02,NEFT,0.0,39771.74,318173.89
2020-12-02,Miscellaneous,0.0,45453.41,272720.48
2020-12-02,Cash,0.0,45453.41,227267.07
2020-12-02,Reversal,0.8,0.0,227267.87
2020-12-02,Miscellaneous,0.0,37877.98,189389.89
2020-12-02,Reversal,0.0,189389.89,0.0
2020-12-02,ATM,7.9,0.0,7.9
2020-12-02,Reversal,2495.77,0.0,2503.67
2020-12-02,IMPS,0.0,278.19,2225.48
2020-12-02,Purchase,0.0,278.19,1947.3
2020-12-02,Cash,31096.0,0.0,33043.3
2020-12-02,IMPS,398.34,0.0,33441.64
2020-12-02,Reversal,0.0,33441.64,0.0
2020-12-02,Purchase,4.5,0.0,4.5
2020-12-02,NEFT,0.0,0.64,3.86
2020-12-02,Purchase,447.0,0.0,450.86
2020-12-02,Transfer,215584.91,0.0,216035.77
2020-12-02,IMPS,0.0,43207.15,172828.62
2020-12-02,Tax,10.43,0.0,172839.05
2020-12-02,Cash,26772.04,0.0,199611.09
2020-12-02,RTGS,0.0,99805.55,99805.54
2020-12-02,Bill,168531.5,0.0,268337.04
2020-12-02,Bill,0.0,26833.7,241503.34
2020-12-02,Tax,0.0,40250.56,201252.78
2020-12-02,Interest,5.4,0.0,201258.18
2020-12-02,Tax,4.0,0.0,201262.18
2020-12-02,RTGS,0.0,67087.39,134174.79
2020-12-02,Tax,0.0,33543.7,100631.09
2020-12-02,Bill,0.0,20126.22,80504.87
2020-12-02,Debit Card,23312.3,0.0,103817.17
2020-12-02,Miscellaneous,0.0,12977.15,90840.02
2020-12-02,Tax,52.0,0.0,90892.02
2020-12-02,Miscellaneous,4191.3,0.0,95083.32
2020-12-02,Debit Card,2054461.0,0.0,2149544.32
2020-12-02,Debit Card,0.0,307077.76,1842466.56
2020-12-02,ATM,0.0,921233.28,921233.28
2020-12-02,Bill,24.0,0.0,921257.28
2020-12-02,NEFT,0.0,184251.46,737005.82
2020-12-02,IMPS,3278.73,0.0,740284.55
2020-12-02,Transfer,21741.1,0.0,762025.65
2020-12-02,RTGS,0.0,95253.21,666772.44
2020-12-02,Tax,0.0,333386.22,333386.22
2020-12-02,IMPS,0.0,41673.28,291712.94
2020-12-02,Cheque,20564.07,0.0,312277.01
2020-12-02,Commission,672.0,0.0,312949.01
2020-12-02,Bill,0.0,39118.63,273830.38
2020-12-02,Cheque,15022.0,0.0,288852.38
2020-12-02,RTGS,686688.0,0.0,975540.38
2020-12-02,RTGS,0.0,108393.38,867147.0
2020-12-02,NEFT,1306153.0,0.0,2173300.0
2020-12-02,Miscellaneous,2282.7,0.0,2175582.7
2020-12-02,Interest,0.0,271947.84,1903634.86
2020-12-02,Miscellaneous,15581.5,0.0,1919216.36
2020-12-02,Reversal,1638260.0,0.0,3557476.36
2020-12-02,Bill,7.97,0.0,3557484.33
2020-12-02,ATM,0.0,1185828.11,2371656.22
2020-12-02,NEFT,0.0,263517.36,2108138.86
2020-12-02,IMPS,0.0,1054069.43,1054069.43
2020-12-02,Cheque,18.7,0.0,1054088.13
2020-12-02,Commission,0.0,131761.02,922327.11
2020-12-02,Miscellaneous,12.9,0.0,922340.01
2020-12-02,Miscellaneous,0.0,92234.0,830106.01
2020-12-02,Tax,130529.0,0.0,960635.01
2020-12-02,Cash,16.91,0.0,960651.92
2020-12-02,IMPS,189291.25,0.0,1149943.17
2020-12-02,RTGS,0.0,164277.6,985665.57
2020-12-02,Debit Card,17741.9,0.0,1003407.47
2020-12-02,ATM,0.0,125425.93,877981.54
2020-12-02,Cheque,0.0,175596.31,702385.23
2020-12-02,Debit Card,627.5,0.0,703012.73
2020-12-02,IMPS,1107083.8,0.0,1810096.53
2020-12-02,Bill,8122.5,0.0,1818219.03
2020-12-03,Bill,3.7,0.0,1818222.73
2020-12-04,Bill,0.0,259746.1,1558476.63
2020-12-04,Interest,0.0,222639.52,1335837.11
2020-12-04,ATM,0.0,267167.42,1068669.69
2020-12-05,Interest,0.0,152667.1,916002.59
2020-12-05,Reversal,0.0,114500.32,801502.27
2020-12-05,Reversal,0.0,160300.45,641201.82
2020-12-05,Tax,122102.9,0.0,763304.72
2020-12-05,Cheque,478.51,0.0,763783.23
2020-12-05,Tax,0.0,127297.21,636486.02
2020-12-05,Commission,0.0,318243.01,318243.01
2020-12-05,Cheque,0.0,35360.33,282882.68
2020-12-05,Tax,0.0,56576.54,226306.14
2020-12-05,Miscellaneous,253.0,0.0,226559.14
2020-12-05,Interest,0.0,32365.59,194193.55
2020-12-05,Purchase,0.0,48548.39,145645.16
2020-12-05,Debit Card,6.0,0.0,145651.16
2020-12-05,ATM,80.8,0.0,145731.96
2020-12-05,RTGS,0.0,48577.32,97154.64
2020-12-05,Bill,0.0,12144.33,85010.31
2020-12-05,Interest,0.0,10626.29,74384.02
2020-12-05,NEFT,33.45,0.0,74417.47
2020-12-05,Interest,0.0,9302.18,65115.29
2020-12-05,Tax,0.0,8139.41,56975.88
2020-12-05,IMPS,0.0,11395.18,45580.7
2020-12-05,Tax,0.0,7596.78,37983.92
2020-12-05,Cheque,0.0,37983.92,0.0
2020-12-05,Tax,212667.8,0.0,212667.8
2020-12-05,ATM,2462.64,0.0,215130.44
2020-12-05,Debit Card,0.0,35855.07,179275.37
2020-12-05,Reversal,0.0,17927.54,161347.83
2020-12-05,Cash,0.0,26891.31,134456.52
2020-12-05,RTGS,1730089.0,0.0,1864545.52
2020-12-05,Transfer,7.56,0.0,1864553.08
2020-12-05,NEFT,0.0,621517.69,1243035.39
2020-12-05,Cash,29.48,0.0,1243064.87
2020-12-05,Purchase,0.0,248612.97,994451.9
2020-12-05,Transfer,0.0,198890.38,795561.52
2020-12-05,Cash,0.0,265187.17,530374.35
2020-12-05,Interest,0.0,530374.35,0.0
2020-12-05,Bill,1716175.25,0.0,1716175.25
2020-12-05,IMPS,0.0,171617.53,1544557.72
2020-12-06,Transfer,0.0,193069.72,1351488.0
2020-12-06,ATM,0.0,193069.71,1158418.29
2020-12-06,IMPS,0.0,115841.83,1042576.46
2020-12-06,Purchase,2185.0,0.0,1044761.46
2020-12-06,Commission,9.7,0.0,1044771.16
2020-12-06,Purchase,0.0,149253.02,895518.14
2020-12-06,Debit Card,0.0,111939.77,783578.37
2020-12-06,Miscellaneous,12056.23,0.0,795634.6
2020-12-06,IMPS,271.21,0.0,795905.81
2020-12-06,Reversal,0.0,198976.45,596929.36
2020-12-06,Tax,0.0,66325.48,530603.88
2020-12-06,Reversal,2370.41,0.0,532974.29
2020-12-06,Miscellaneous,0.0,133243.57,399730.72
2020-12-06,ATM,0.0,399730.72,0.0
2020-12-06,Bill,11859.4,0.0,11859.4
2020-12-06,RTGS,0.0,3953.13,7906.27
2020-12-06,Tax,239093.1,0.0,246999.37
2020-12-06,ATM,688.9,0.0,247688.27
2020-12-06,Interest,1031646.25,0.0,1279334.52
2020-12-06,Cheque,0.0,159916.82,1119417.7
2020-12-06,Interest,0.0,124379.74,995037.96
2020-12-06,NEFT,0.0,199007.59,796030.37
2020-12-06,Commission,4.42,0.0,796034.79
2020-12-07,Interest,0.0,99504.35,696530.44
2020-12-07,Tax,3.9,0.0,696534.34
2020-12-07,Cash,16.9,0.0,696551.24
2020-12-07,Reversal,4641.07,0.0,701192.31
2020-12-07,Interest,0.0,116865.39,584326.93
2020-12-07,Cash,0.0,73040.87,511286.06
2020-12-07,RTGS,6.37,0.0,511292.43
2020-12-07,Commission,0.0,170430.81,340861.62
2020-12-07,Miscellaneous,158134.1,0.0,498995.72
2020-12-07,NEFT,0.0,498995.72,0.0
2020-12-07,Reversal,7.0,0.0,7.0
2020-12-07,Reversal,1886.6,0.0,1893.6
2020-12-07,Purchase,0.0,270.51,1623.09
2020-12-07,Bill,1082696.0,0.0,1084319.09
2020-12-07,Reversal,0.0,135539.89,948779.2
2020-12-07,Transfer,211.0,0.0,948990.2
2020-12-07,IMPS,3.98,0.0,948994.18
2020-12-07,RTGS,0.0,118624.27,830369.91
2020-12-07,NEFT,0.0,830369.91,0.0
2020-12-07,Bill,10994.3,0.0,10994.3
2020-12-07,Cash,0.0,2748.58,8245.72
2020-12-07,Transfer,240329.7,0.0,248575.42
2020-12-07,Commission,7.83,0.0,248583.25
2020-12-07,Reversal,0.0,41430.54,207152.71
2020-12-07,Purchase,0.0,41430.54,165722.17
2020-12-07,Commission,445.61,0.0,166167.78
2020-12-07,Bill,0.0,83083.89,83083.89
2020-12-07,IMPS,236751.0,0.0,319834.89
2020-12-07,Interest,238.96,0.0,320073.85
2020-12-07,Bill,1812947.75,0.0,2133021.6
2020-12-07,Commission,0.0,426604.32,1706417.28
2020-12-07,IMPS,25.2,0.0,1706442.48
2020-12-07,Purchase,29183.3,0.0,1735625.78
2020-12-07,Commission,2019974.8,0.0,3755600.58
2020-12-07,Miscellaneous,0.0,536514.37,3219086.21
2020-12-07,Purchase,0.0,536514.37,2682571.84
2020-12-07,Commission,0.0,298063.54,2384508.3
2020-12-08,Tax,0.0,397418.05,1987090.25
2020-12-08,Bill,127992.0,0.0,2115082.25
2020-12-08,Cash,0.0,211508.23,1903574.02
2020-12-08,NEFT,59313.0,0.0,1962887.02
2020-12-08,IMPS,6.97,0.0,1962893.99
2020-12-08,Interest,0.0,327149.0,1635744.99
2020-12-08,Commission,0.0,163574.5,1472170.49
2020-12-08,Purchase,0.0,245361.75,1226808.74
2020-12-08,Commission,0.0,245361.75,981446.99
2020-12-08,IMPS,30.29,0.0,981477.28
2020-12-08,Cash,155109.0,0.0,1136586.28
2020-12-08,Debit Card,77367.9,0.0,1213954.18
2020-12-08,Tax,5.34,0.0,1213959.52
2020-12-08,Tax,1698192.5,0.0,2912152.02
2020-12-08,ATM,0.0,323572.45,2588579.57
2020-12-08,Interest,0.0,862859.86,1725719.71
2020-12-08,Tax,0.0,575239.9,1150479.81
2020-12-08,ATM,44333.0,0.0,1194812.81
2020-12-08,Miscellaneous,185401.4,0.0,1380214.21
2020-12-08,Commission,0.0,690107.11,690107.1
2020-12-08,Cheque,2773.92,0.0,692881.02
2020-12-08,Tax,0.0,69288.1,623592.92
2020-12-08,Reversal,0.0,103932.15,519660.77
2020-12-08,Commission,0.0,129915.19,389745.58
2020-12-08,NEFT,55.1,0.0,389800.68
2020-12-08,Commission,1166337.5,0.0,1556138.18
2020-12-08,Reversal,208625.0,0.0,1764763.18
2020-12-08,Transfer,114091.0,0.0,1878854.18
2020-12-08,NEFT,30.36,0.0,1878884.54
2020-12-08,Reversal,0.0,469721.14,1409163.4
2020-12-08,NEFT,0.0,281832.68,1127330.72
2020-12-08,Cheque,7.4,0.0,1127338.12
2020-12-08,Miscellaneous,4.0,0.0,1127342.12
2020-12-08,Miscellaneous,1813784.0,0.0,2941126.12
2020-12-08,Debit Card,0.0,367640.77,2573485.36
2020-12-08,Transfer,0.0,428914.23,2144571.13
2020-12-08,Transfer,56.5,0.0,2144627.63
2020-12-08,Tax,4524.0,0.0,2149151.63
2020-12-08,Cheque,0.0,2149151.63,0.0
2020-12-08,IMPS,210860.0,0.0,210860.0
2020-12-08,Debit Card,22861.9,0.0,233721.9
2020-12-08,Bill,1207470.0,0.0,1441191.9
2020-12-08,ATM,2839.66,0.0,1444031.56
2020-12-08,Cheque,0.0,240671.93,1203359.63
2020-12-08,Bill,0.0,120335.96,1083023.67
2020-12-08,Commission,0.0,361007.89,722015.78
2020-12-08,NEFT,0.0,240671.93,481343.85
2020-12-08,Bill,0.0,160447.95,320895.9
2020-12-08,Tax,0.0,320895.9,0.0
2020-12-08,Debit Card,879299.5,0.0,879299.5
2020-12-08,Bill,0.0,219824.88,659474.62
2020-12-09,Commission,1869901.0,0.0,2529375.62
2020-12-09,IMPS,0.0,2529375.62,0.0
2020-12-09,Debit Card,4.49,0.0,4.49
2020-12-09,Transfer,602022.0,0.0,602026.49
2020-12-09,Transfer,748.5,0.0,602774.99
2020-12-09,Purchase,18048.1,0.0,620823.09
2020-12-09,Cheque,0.0,155205.77,465617.32
2020-12-09,Cheque,27.0,0.0,465644.32
2020-12-09,Cheque,0.0,0.0,465644.32
2020-12-09,Reversal,3161.0,0.0,468805.32
2020-12-09,Reversal,1.73,0.0,468807.05
2020-12-09,Commission,128769.5,0.0,597576.55
2020-12-09,Debit Card,1414030.0,0.0,2011606.55
2020-12-10,Miscellaneous,813578.0,0.0,2825184.55
2020-12-10,ATM,346.2,0.0,2825530.75
2020-12-10,Commission,0.0,706382.69,2119148.06
2020-12-10,Transfer,0.0,423829.61,1695318.45
2020-12-10,Cheque,0.0,188368.72,1506949.73
2020-12-10,IMPS,0.0,251158.29,1255791.44
2020-12-10,NEFT,16555.8,0.0,1272347.24
2020-12-10,Tax,60.16,0.0,1272407.4
2020-12-10,RTGS,0.0,1272407.4,0.0
2020-12-10,Purchase,51.22,0.0,51.22
2020-12-10,Cheque,0.0,10.24,40.98
2020-12-10,Miscellaneous,3679.0,0.0,3719.98
2020-12-10,Cheque,1842.0,0.0,5561.98
2020-12-10,IMPS,4841.0,0.0,10402.98
2020-12-10,RTGS,0.0,3467.66,6935.32
2020-12-10,Tax,0.0,1733.83,5201.49
2020-12-10,Commission,0.0,2600.75,2600.74
2020-12-10,Cash,3.83,0.0,2604.57
2020-12-10,RTGS,159995.25,0.0,162599.82
2020-12-10,RTGS,0.0,32519.96,130079.86
2020-12-10,NEFT,27424.1,0.0,157503.96
2020-12-10,Interest,0.0,39375.99,118127.97
2020-12-10,Purchase,0.0,14766.0,103361.97
2020-12-10,ATM,0.0,12920.25,90441.72
2020-12-10,Cheque,5.0,0.0,90446.72
2020-12-10,IMPS,1452721.5,0.0,1543168.22
2020-12-10,Commission,0.0,771584.11,771584.11
2020-12-10,Cash,0.0,128597.35,642986.76
2020-12-10,IMPS,19835.2,0.0,662821.96
2020-12-10,Tax,0.0,73646.88,589175.08
2020-12-10,Reversal,2145.3,0.0,591320.38
2020-12-10,Reversal,0.0,65702.26,525618.12
2020-12-10,Cash,3573.57,0.0,529191.69
2020-12-10,Debit Card,0.0,75598.81,453592.88
2020-12-10,Debit Card,0.0,75598.81,377994.07
2020-12-10,Transfer,0.0,75598.81,302395.26
2020-12-10,Debit Card,37.0,0.0,302432.26
2020-12-10,Purchase,989122.5,0.0,1291554.76
2020-12-10,NEFT,9.25,0.0,1291564.01
2020-12-10,Cash,0.0,143507.11,1148056.9
2020-12-10,RTGS,9.5,0.0,1148066.4
2020-12-10,Commission,0.0,127562.93,1020503.47
2020-12-10,Reversal,0.0,170083.91,850419.56
2020-12-10,RTGS,0.0,283473.19,566946.37
2020-12-11,Commission,0.0,62994.04,503952.33
2020-12-11,Cheque,0.0,167984.11,335968.22
2020-12-11,Tax,33.0,0.0,336001.22
2020-12-11,Interest,2.09,0.0,336003.31
2020-12-11,Reversal,107.67,0.0,336110.98
2020-12-11,Tax,206195.5,0.0,542306.48
2020-12-11,Cash,25426.3,0.0,567732.78
2020-12-11,Cash,365.0,0.0,568097.78
2020-12-11,Interest,353.13,0.0,568450.91
2020-12-11,ATM,5.0,0.0,568455.91
2020-12-11,ATM,6.02,0.0,568461.93
2020-12-11,Cheque,183385.0,0.0,751846.93
2020-12-11,Tax,0.0,751846.93,0.0
2020-12-11,NEFT,2.0,0.0,2.0
2020-12-11,Interest,0.0,0.2,1.8
2020-12-11,Commission,1267.6,0.0,1269.4
2020-12-11,Purchase,46.4,0.0,1315.8
2020-12-11,Transfer,0.0,657.9,657.9
2020-12-11,IMPS,69287.5,0.0,69945.4
2020-12-11,Transfer,0.0,69945.4,0.0
2020-12-11,Debit Card,24144.9,0.0,24144.9
2020-12-11,RTGS,0.0,3449.27,20695.63
2020-12-11,Reversal,61.0,0.0,20756.63
2020-12-11,Tax,0.0,3459.44,17297.19
2020-12-11,Cheque,24985.0,0.0,42282.19
2020-12-11,Transfer,22312.41,0.0,64594.6
2020-12-11,Commission,43.47,0.0,64638.07
2020-12-11,Debit Card,2435.1,0.0,67073.17
2020-12-11,Reversal,222871.97,0.0,289945.14
2020-12-11,Debit Card,161366.7,0.0,451311.84
2020-12-11,ATM,0.0,150437.28,300874.56
2020-12-11,IMPS,725.0,0.0,301599.56
2020-12-11,Purchase,0.0,33511.06,268088.5
2020-12-11,Commission,731888.5,0.0,999977.0
2020-12-11,Purchase,7.08,0.0,999984.08
2020-12-11,Purchase,0.0,142854.87,857129.21
2020-12-11,RTGS,12024.7,0.0,869153.91
2020-12-11,Interest,111.0,0.0,869264.91
2020-12-11,Debit Card,9.8,0.0,869274.71
2020-12-11,RTGS,0.0,289758.24,579516.47
2020-12-11,IMPS,0.0,144879.12,434637.35
2020-12-11,IMPS,0.0,86927.47,347709.88
2020-12-11,Interest,550.0,0.0,348259.88
2020-12-11,Cash,0.0,38695.54,309564.34
2020-12-11,Cheque,17.0,0.0,309581.34
2020-12-11,Interest,0.0,34397.93,275183.41
2020-12-11,Tax,0.0,45863.9,229319.51
2020-12-11,Miscellaneous,0.0,114659.76,114659.76
2020-12-11,Cheque,56.37,0.0,114716.13
2020-12-11,Interest,378.0,0.0,115094.13
2020-12-11,Commission,3.7,0.0,115097.83
2020-12-11,ATM,527382.0,0.0,642479.83
2020-12-11,Reversal,6.0,0.0,642485.83
2020-12-11,Miscellaneous,0.0,214161.94,428323.89
2020-12-11,Commission,0.0,85664.78,342659.11
2020-12-11,Commission,656577.0,0.0,999236.11
2020-12-11,Bill,87.0,0.0,999323.11
2020-12-11,RTGS,1926258.0,0.0,2925581.11
2020-12-11,Purchase,440.0,0.0,2926021.11
2020-12-11,Tax,1907468.0,0.0,4833489.11
2020-12-11,Cash,0.0,537054.35,4296434.76
2020-12-11,Cash,0.0,537054.35,3759380.42
2020-12-11,Reversal,0.0,3759380.42,0.0
2020-12-11,Cash,1194743.0,0.0,1194743.0
2020-12-11,Cheque,695307.0,0.0,1890050.0
2020-12-11,ATM,4861.0,0.0,1894911.0
2020-12-12,Commission,195616.25,0.0,2090527.25
2020-12-12,Commission,0.0,696842.42,1393684.83
2020-12-12,RTGS,0.0,348421.21,1045263.62
2020-12-12,IMPS,0.0,1045263.62,0.0
2020-12-12,Cash,61.0,0.0,61.0
2020-12-12,Cash,2017197.0,0.0,2017258.0
2020-12-13,Miscellaneous,22649.3,0.0,2039907.3
2020-12-13,Commission,6.0,0.0,2039913.3
2020-12-13,Reversal,19.0,0.0,2039932.3
2020-12-13,Reversal,0.1,0.0,2039932.4
2020-12-13,Transfer,950.2,0.0,2040882.6
2020-12-13,Cash,263354.0,0.0,2304236.6
2020-12-13,IMPS,1766121.0,0.0,4070357.6
2020-12-13,Bill,205148.0,0.0,4275505.6
2020-12-13,Interest,0.0,475056.18,3800449.42
2020-12-13,Purchase,1744.0,0.0,3802193.42
2020-12-13,Debit Card,0.0,422465.94,3379727.48
2020-12-13,NEFT,0.0,3379727.48,0.0
2020-12-13,IMPS,2479.2,0.0,2479.2
2020-12-13,IMPS,69881.94,0.0,72361.14
2020-12-13,Bill,48.0,0.0,72409.14
2020-12-13,Debit Card,150675.0,0.0,223084.14
2020-12-13,RTGS,0.0,37180.69,185903.45
2020-12-13,Interest,0.0,18590.35,167313.11
2020-12-13,IMPS,0.0,33462.62,133850.49
2020-12-13,Commission,35.0,0.0,133885.49
2020-12-13,Miscellaneous,0.0,13388.55,120496.94
2020-12-13,ATM,1927525.5,0.0,2048022.44
2020-12-13,Tax,0.0,204802.24,1843220.2
2020-12-13,Cash,0.0,921610.1,921610.1
2020-12-13,Debit Card,0.0,92161.01,829449.09
2020-12-13,Cheque,211.7,0.0,829660.79
2020-12-13,IMPS,0.0,92184.53,737476.26
2020-12-13,Cash,0.0,73747.63,663728.63
2020-12-13,Purchase,32167.84,0.0,695896.47
2020-12-13,NEFT,52.07,0.0,695948.54
2020-12-13,Miscellaneous,0.0,69594.85,626353.69
2020-12-13,Miscellaneous,2029.76,0.0,628383.45
2020-12-13,ATM,0.0,157095.86,471287.59
2020-12-13,RTGS,0.0,157095.86,314191.73
2020-12-13,Cash,1457.31,0.0,315649.04
2020-12-13,NEFT,3486.66,0.0,319135.7
2020-12-14,NEFT,165999.5,0.0,485135.2
2020-12-14,Cheque,0.0,48513.52,436621.68
2020-12-14,Cash,0.0,87324.34,349297.34
2020-12-14,Purchase,2013371.0,0.0,2362668.34
2020-12-14,IMPS,19.0,0.0,2362687.34
2020-12-14,Debit Card,61.0,0.0,2362748.34
2020-12-14,Transfer,119.81,0.0,2362868.15
2020-12-14,Transfer,0.0,787622.72,1575245.43
2020-12-14,NEFT,28656.0,0.0,1603901.43
2020-12-14,RTGS,0.0,267316.91,1336584.52
2020-12-14,Cheque,0.0,190940.65,1145643.87
2020-12-14,RTGS,34.8,0.0,1145678.67
2020-12-14,Cash,0.0,163668.38,982010.29
2020-12-14,RTGS,0.0,196402.06,785608.23
2020-12-14,Commission,0.0,392804.12,392804.12
2020-12-14,ATM,0.0,130934.71,261869.41
2020-12-14,Cheque,0.0,29096.6,232772.81
2020-12-14,Cash,131.0,0.0,232903.81
2020-12-14,NEFT,2253.2,0.0,235157.01
2020-12-14,Transfer,2507.33,0.0,237664.34
2020-12-14,RTGS,15568.9,0.0,253233.24
2020-12-14,Cheque,0.0,28137.03,225096.21
2020-12-14,Commission,2602.0,0.0,227698.21
2020-12-14,Miscellaneous,0.0,56924.55,170773.66
2020-12-14,Purchase,0.0,28462.28,142311.38
2020-12-14,NEFT,359123.5,0.0,501434.88
2020-12-14,Purchase,0.0,55714.99,445719.89
2020-12-14,Interest,166635.6,0.0,612355.49
2020-12-14,Transfer,0.0,612355.49,0.0
2020-12-14,Transfer,36.0,0.0,36.0
2020-12-14,Cheque,0.0,3.6,32.4
2020-12-14,Cash,0.0,16.2,16.2
2020-12-14,Purchase,7434.31,0.0,7450.51
2020-12-14,RTGS,0.0,745.05,6705.46
2020-12-14,Interest,0.0,2235.15,4470.31
2020-12-14,Purchase,3.45,0.0,4473.76
2020-12-14,Bill,17001.0,0.0,21474.76
2020-12-14,IMPS,0.0,21474.76,0.0
2020-12-14,ATM,10046.4,0.0,10046.4
2020-12-14,Cheque,0.0,1674.4,8372.0
2020-12-14,RTGS,0.0,837.2,7534.8
2020-12-14,Miscellaneous,0.0,1076.4,6458.4
2020-12-14,Miscellaneous,0.0,807.3,5651.1
2020-12-14,Purchase,142217.12,0.0,147868.22
2020-12-14,Debit Card,119.0,0.0,147987.22
2020-12-14,RTGS,0.0,36996.81,110990.42
2020-12-14,Reversal,1621634.2,0.0,1732624.62
2020-12-14,Tax,0.0,192513.85,1540110.77
2020-12-14,Interest,3.0,0.0,1540113.77
2020-12-14,Tax,364.0,0.0,1540477.77
2020-12-14,RTGS,0.0,220068.25,1320409.52
2020-12-14,Transfer,6.09,0.0,1320415.61
2020-12-14,Commission,173962.3,0.0,1494377.91
2020-12-14,Cheque,174.8,0.0,1494552.71
2020-12-14,Miscellaneous,13.94,0.0,1494566.65
2020-12-14,ATM,0.0,498188.88,996377.77
2020-12-14,Debit Card,0.0,99637.78,896739.99
2020-12-14,Transfer,54.0,0.0,896793.99
2020-12-14,Miscellaneous,0.0,179358.8,717435.19
2020-12-14,Tax,0.0,358717.6,358717.6
2020-12-14,Miscellaneous,0.0,51245.37,307472.23
2020-12-14,Debit Card,4.41,0.0,307476.64
2020-12-14,Tax,0.0,38434.58,269042.06
2020-12-14,Miscellaneous,162528.0,0.0,431570.06
2020-12-14,Tax,0.0,53946.26,377623.8
2020-12-14,Cash,0.0,377623.8,0.0
2020-12-14,Cheque,6.9,0.0,6.9
2020-12-14,IMPS,485.0,0.0,491.9
2020-12-14,ATM,0.0,54.66,437.24
2020-12-14,Commission,1124732.5,0.0,1125169.74
2020-12-14,RTGS,0.0,125018.86,1000150.88
2020-12-14,NEFT,0.0,125018.86,875132.02
2020-12-14,Bill,1846.2,0.0,876978.22
2020-12-14,Tax,267.5,0.0,877245.72
2020-12-14,Transfer,0.0,87724.57,789521.15
2020-12-14,Transfer,0.0,98690.14,690831.01
2020-12-14,RTGS,0.0,690831.01,0.0
2020-12-14,RTGS,4983.0,0.0,4983.0
2020-12-14,Debit Card,0.0,4983.0,0.0
2020-12-14,Transfer,7.0,0.0,7.0
2020-12-14,RTGS,8.0,0.0,15.0
2020-12-14,Reversal,0.0,1.88,13.12
2020-12-14,Cheque,4003.0,0.0,4016.12
2020-12-14,ATM,1353.17,0.0,5369.29
2020-12-14,Miscellaneous,0.0,1789.76,3579.53
2020-12-14,Commission,0.0,596.59,2982.94
2020-12-14,RTGS,67792.0,0.0,70774.94
2020-12-14,Transfer,957410.0,0.0,1028184.94
2020-12-14,Cheque,208935.72,0.0,1237120.66
2020-12-14,NEFT,0.0,206186.78,1030933.88
2020-12-14,Commission,0.0,206186.78,824747.1
2020-12-14,RTGS,192738.0,0.0,1017485.1
2020-12-14,Reversal,1840816.75,0.0,2858301.85
2020-12-14,Interest,3881.0,0.0,2862182.85
2020-12-14,Commission,2634.0,0.0,2864816.85
2020-12-14,Tax,114648.0,0.0,2979464.85
2020-12-14,IMPS,0.0,297946.49,2681518.37
2020-12-14,RTGS,0.0,297946.49,2383571.88
2020-12-14,Debit Card,0.0,2383571.88,0.0
2020-12-14,Bill,131.1,0.0,131.1
2020-12-14,Transfer,0.0,26.22,104.88
2020-12-14,Cash,0.0,104.88,0.0
2020-12-14,Purchase,150937.53,0.0,150937.53
2020-12-14,IMPS,0.0,21562.5,129375.03
2020-12-14,Purchase,0.0,12937.5,116437.53
2020-12-14,NEFT,51.85,0.0,116489.38
2020-12-14,Transfer,0.0,11648.94,104840.44
2020-12-14,Interest,1786.0,0.0,106626.44
2020-12-14,Debit Card,212055.6,0.0,318682.04
2020-12-14,NEFT,400.0,0.0,319082.04
2020-12-14,Cash,0.0,45583.15,273498.89
2020-12-14,Commission,0.0,68374.72,205124.17
2020-12-14,ATM,0.0,20512.42,184611.75
2020-12-14,Bill,0.0,18461.18,166150.58
2020-12-14,Interest,9820.0,0.0,175970.58
2020-12-14,NEFT,0.0,175970.58,0.0
2020-12-14,Purchase,98.26,0.0,98.26
2020-12-14,Miscellaneous,0.0,49.13,49.13
2020-12-14,NEFT,56.0,0.0,105.13
2020-12-14,Cheque,172631.0,0.0,172736.13
2020-12-14,Debit Card,0.0,17273.61,155462.52
2020-12-14,Reversal,52.0,0.0,155514.52
2020-12-14,Transfer,2551.0,0.0,158065.52
2020-12-14,Commission,0.0,79032.76,79032.76
2020-12-14,RTGS,0.0,15806.55,63226.21
2020-12-14,Cash,31.82,0.0,63258.03
2020-12-14,Cash,0.0,21086.01,42172.02
2020-12-14,IMPS,397488.0,0.0,439660.02
2020-12-14,NEFT,0.0,62808.57,376851.45
2020-12-14,Bill,0.0,188425.73,188425.72
2020-12-14,Bill,44.0,0.0,188469.72
2020-12-14,Debit Card,229403.0,0.0,417872.72
2020-12-14,Tax,4.59,0.0,417877.31
2020-12-14,Commission,0.0,83575.46,334301.85
2020-12-14,ATM,0.0,111433.95,222867.9
2020-12-14,Cheque,0.0,24763.1,198104.8
2020-12-14,Miscellaneous,0.0,39620.96,158483.84
2020-12-14,Purchase,2.0,0.0,158485.84
2020-12-14,Bill,0.0,26414.31,132071.53
2020-12-14,RTGS,181.7,0.0,132253.23
2020-12-14,Miscellaneous,0.0,33063.31,99189.92
2020-12-14,Purchase,0.0,9918.99,89270.93
2020-12-14,Cash,2034.1,0.0,91305.03
2020-12-14,Transfer,0.0,10145.0,81160.03
2020-12-14,Bill,0.0,11594.29,69565.74
2020-12-14,Interest,4.11,0.0,69569.85
2020-12-14,NEFT,0.0,17392.46,52177.39
2020-12-14,Transfer,189888.9,0.0,242066.29
2020-12-14,Cash,2850.3,0.0,244916.59
2020-12-14,IMPS,256043.1,0.0,500959.69
2020-12-14,Transfer,0.0,55662.19,445297.5
2020-12-14,Debit Card,0.0,63613.93,381683.57
2020-12-14,Cheque,0.0,381683.57,0.0
2020-12-14,Purchase,413747.5,0.0,413747.5
2020-12-14,NEFT,377.1,0.0,414124.6
2020-12-14,Purchase,0.0,138041.53,276083.07
2020-12-14,Bill,0.0,276083.07,0.0
2020-12-14,Transfer,1992366.0,0.0,1992366.0
2020-12-14,Cheque,0.0,398473.2,1593892.8
2020-12-14,Tax,3172.77,0.0,1597065.57
2020-12-14,NEFT,0.0,266177.6,1330887.98
2020-12-14,Cash,0.0,190126.85,1140761.13
2020-12-14,IMPS,0.0,228152.23,912608.9
2020-12-14,Interest,1051.0,0.0,913659.9
2020-12-14,Transfer,0.0,91365.99,822293.91
2020-12-14,Commission,0.0,164458.78,657835.13
2020-12-14,ATM,22183.9,0.0,680019.03
2020-12-14,Debit Card,65791.75,0.0,745810.78
2020-12-14,Purchase,0.0,186452.7,559358.08
2020-12-14,ATM,0.0,79908.3,479449.78
2020-12-14,Bill,0.0,119862.45,359587.34
2020-12-14,Reversal,535465.0,0.0,895052.34
2020-12-14,Purchase,0.0,298350.78,596701.56
2020-12-14,Debit Card,24.0,0.0,596725.56
2020-12-14,Transfer,100.06,0.0,596825.62
2020-12-14,ATM,0.0,198941.87,397883.75
2020-12-14,Cash,0.0,44209.31,353674.44
2020-12-14,Miscellaneous,6.1,0.0,353680.54
2020-12-14,Cash,0.0,35368.05,318312.49
2020-12-14,Debit Card,0.0,318312.49,0.0
2020-12-14,IMPS,60595.0,0.0,60595.0
2020-12-14,Bill,402.86,0.0,60997.86
2020-12-14,Cash,450.0,0.0,61447.86
2020-12-14,Miscellaneous,412.2,0.0,61860.06
2020-12-14,Bill,0.0,6186.01,55674.05
2020-12-14,Miscellaneous,1264011.5,0.0,1319685.55
2020-12-14,NEFT,0.0,219947.59,1099737.96
2020-12-14,IMPS,2797.0,0.0,1102534.96
2020-12-14,Reversal,1160441.0,0.0,2262975.96
2020-12-14,ATM,28.8,0.0,2263004.76
2020-12-14,Tax,7.0,0.0,2263011.76
2020-12-15,RTGS,35.8,0.0,2263047.56
2020-12-15,Cheque,693771.75,0.0,2956819.31
2020-12-15,Interest,818.0,0.0,2957637.31
2020-12-15,Cheque,62.8,0.0,2957700.11
2020-12-15,Debit Card,0.0,591540.02,2366160.09
2020-12-15,Tax,896958.75,0.0,3263118.84
2020-12-15,Cheque,0.0,407889.86,2855228.98
2020-12-15,ATM,0.0,475871.5,2379357.48
2020-12-16,IMPS,0.0,396559.58,1982797.9
2020-12-16,ATM,2.9,0.0,1982800.8
2020-12-16,Cheque,0.0,247850.1,1734950.7
2020-12-16,Commission,18.0,0.0,1734968.7
2020-12-16,Interest,1860481.0,0.0,3595449.7
2020-12-16,Tax,3.8,0.0,3595453.5
2020-12-16,Tax,0.0,399494.83,3195958.67
2020-12-16,Interest,2210.74,0.0,3198169.41
2020-12-16,NEFT,560.9,0.0,3198730.31
2020-12-16,Cash,14626.37,0.0,3213356.68
2020-12-16,Transfer,216729.7,0.0,3430086.38
2020-12-16,Reversal,359.7,0.0,3430446.08
2020-12-16,RTGS,26022.86,0.0,3456468.94
2020-12-16,Cheque,25331.2,0.0,3481800.14
2020-12-16,Bill,0.0,870450.04,2611350.1
2020-12-16,NEFT,0.0,326418.76,2284931.34
2020-12-16,ATM,1763138.0,0.0,4048069.34
2020-12-16,RTGS,0.0,1349356.45,2698712.89
2020-12-16,Reversal,4.3,0.0,2698717.19
2020-12-16,Commission,48.0,0.0,2698765.19
2020-12-16,Miscellaneous,0.0,899588.4,1799176.79
2020-12-16,Debit Card,0.0,257025.26,1542151.53
2020-12-16,Commission,290.0,0.0,1542441.53
2020-12-16,Reversal,0.0,385610.38,1156831.15
2020-12-16,Cash,2.4,0.0,1156833.55
2020-12-16,RTGS,53.04,0.0,1156886.59
2020-12-16,NEFT,248.0,0.0,1157134.59
2020-12-16,RTGS,0.0,578567.3,578567.3
2020-12-16,Transfer,0.0,115713.46,462853.84
2020-12-16,Purchase,2697.9,0.0,465551.74
2020-12-16,RTGS,0.0,155183.91,310367.83
2020-12-16,Cheque,4.88,0.0,310372.71
2020-12-16,Cash,3.35,0.0,310376.06
2020-12-16,Purchase,71909.22,0.0,382285.28
2020-12-16,Commission,10058.24,0.0,392343.52
2020-12-16,Miscellaneous,0.0,39234.35,353109.17
2020-12-16,Commission,857.0,0.0,353966.17
2020-12-16,ATM,169315.6,0.0,523281.77
2020-12-16,Transfer,21297.0,0.0,544578.77
2020-12-16,Purchase,0.0,181526.26,363052.51
2020-12-16,Commission,3.0,0.0,363055.51
2020-12-16,IMPS,0.0,363055.51,0.0
2020-12-16,Interest,0.0,0.0,0.0
2020-12-16,RTGS,246.8,0.0,246.8
2020-12-16,Tax,0.0,30.85,215.95
2020-12-16,NEFT,0.0,30.85,185.1
2020-12-16,Cheque,0.0,46.28,138.82
2020-12-16,NEFT,54511.0,0.0,54649.82
2020-12-16,Interest,0.0,9108.3,45541.52
2020-12-16,RTGS,241238.72,0.0,286780.24
2020-12-16,Debit Card,0.0,71695.06,215085.18
2020-12-16,Tax,36227.0,0.0,251312.18
2020-12-16,Debit Card,38.0,0.0,251350.18
2020-12-16,Cheque,41.07,0.0,251391.25
2020-12-16,Purchase,0.0,83797.08,167594.17
2020-12-16,RTGS,139499.8,0.0,307093.97
2020-12-17,IMPS,0.0,38386.75,268707.22
2020-12-17,Debit Card,0.0,33588.4,235118.82
2020-12-17,Interest,8715.3,0.0,243834.12
2020-12-17,Cash,0.0,30479.27,213354.86
2020-12-17,ATM,31518.0,0.0,244872.86
2020-12-17,NEFT,3.0,0.0,244875.86
2020-12-18,Tax,235.0,0.0,245110.86
2020-12-18,RTGS,2616.9,0.0,247727.76
2020-12-18,Cheque,5.67,0.0,247733.43
2020-12-18,Cash,0.0,27525.94,220207.49
2020-12-18,NEFT,4604.94,0.0,224812.43
2020-12-18,Tax,16.7,0.0,224829.13
2020-12-18,Reversal,0.0,56207.28,168621.85
2020-12-18,Commission,276.1,0.0,168897.95
2020-12-18,Reversal,0.0,18766.44,150131.51
2020-12-18,Debit Card,345770.25,0.0,495901.76
2020-12-18,Interest,0.0,70843.11,425058.65
2020-12-18,Miscellaneous,16859.12,0.0,441917.77
2020-12-18,Interest,0.0,441917.77,0.0
2020-12-18,Reversal,0.0,0.0,0.0
2020-12-18,Purchase,1131879.0,0.0,1131879.0
2020-12-19,Interest,2026.5,0.0,1133905.5
2020-12-19,Interest,262.0,0.0,1134167.5
2020-12-19,NEFT,510.4,0.0,1134677.9
2020-12-19,NEFT,0.0,567338.95,567338.95
2020-12-19,Cash,35.81,0.0,567374.76
2020-12-19,RTGS,46258.4,0.0,613633.16
2020-12-19,Purchase,29.0,0.0,613662.16
2020-12-19,Interest,154307.6,0.0,767969.76
2020-12-19,RTGS,39.0,0.0,768008.76
2020-12-19,ATM,0.0,96001.1,672007.66
2020-12-19,Debit Card,0.0,224002.55,448005.11
2020-12-19,Reversal,161693.0,0.0,609698.11
2020-12-19,Commission,0.0,60969.81,548728.3
2020-12-19,Transfer,0.0,182909.43,365818.87
2020-12-19,Purchase,0.0,91454.72,274364.15
2020-12-19,Cash,205738.4,0.0,480102.55
2020-12-19,Tax,0.0,96020.51,384082.04
2020-12-19,RTGS,0.0,96020.51,288061.53
2020-12-19,ATM,0.0,72015.38,216046.15
2020-12-19,Debit Card,0.0,108023.08,108023.08
2020-12-19,Purchase,0.0,13502.89,94520.2
2020-12-20,Debit Card,0.0,13502.89,81017.31
2020-12-21,Reversal,0.0,9001.92,72015.39
2020-12-21,Bill,0.0,10287.91,61727.48
2020-12-21,ATM,0.0,6172.75,55554.73
2020-12-21,Miscellaneous,0.0,5555.47,49999.26
2020-12-21,ATM,0.0,4999.93,44999.33
2020-12-21,Tax,0.0,4999.93,39999.4
2020-12-21,Miscellaneous,0.0,6666.57,33332.83
2020-12-21,Reversal,24939.34,0.0,58272.17
2020-12-21,Reversal,0.0,58272.17,0.0
2020-12-21,Interest,21.0,0.0,21.0
2020-12-21,NEFT,0.0,2.1,18.9
2020-12-21,IMPS,179682.0,0.0,179700.9
2020-12-21,Miscellaneous,0.0,19966.77,159734.13
2020-12-21,Purchase,0.0,79867.07,79867.06
2020-12-21,Reversal,2000101.8,0.0,2079968.86
2020-12-21,Bill,0.0,519992.22,1559976.64
2020-12-21,ATM,0.0,311995.33,1247981.31
2020-12-21,Cash,0.0,124798.13,1123183.18
2020-12-21,Debit Card,1.0,0.0,1123184.18
2020-12-21,RTGS,0.0,1123184.18,0.0
2020-12-21,Interest,9218.0,0.0,9218.0
2020-12-21,Miscellaneous,6.0,0.0,9224.0
2020-12-21,IMPS,256077.0,0.0,265301.0
2020-12-21,Interest,84016.2,0.0,349317.2
2020-12-21,Bill,30497.77,0.0,379814.97
2020-12-21,Cash,1366827.0,0.0,1746641.97
2020-12-21,RTGS,0.0,291107.0,1455534.98
2020-12-21,Bill,2022.12,0.0,1457557.1
2020-12-21,Cheque,291.9,0.0,1457849.0
2020-12-21,IMPS,118726.75,0.0,1576575.75
2020-12-21,Bill,0.0,197071.97,1379503.78
2020-12-21,Debit Card,260178.94,0.0,1639682.72
2020-12-21,ATM,0.0,327936.54,1311746.18
2020-12-21,Reversal,0.0,163968.27,1147777.91
2020-12-21,NEFT,0.0,229555.58,918222.33
2020-12-21,Cheque,0.0,91822.23,826400.1
2020-12-21,RTGS,97531.3,0.0,923931.4
2020-12-21,RTGS,284.0,0.0,924215.4
2020-12-22,Debit Card,3490.0,0.0,927705.4
2020-12-22,Reversal,418.1,0.0,928123.5
2020-12-22,NEFT,67144.0,0.0,995267.5
2020-12-22,Debit Card,31492.4,0.0,1026759.9
2020-12-22,Purchase,0.0,114084.43,912675.47
2020-12-22,Bill,0.0,152112.58,760562.89
2020-12-22,Cheque,293.7,0.0,760856.59
2020-12-22,IMPS,27.4,0.0,760883.99
2020-12-22,Interest,0.0,84542.67,676341.32
2020-12-22,ATM,17153.0,0.0,693494.32
2020-12-22,Cash,450.9,0.0,693945.22
2020-12-22,Reversal,0.0,173486.31,520458.92
2020-12-22,Tax,0.0,52045.89,468413.03
2020-12-22,Debit Card,0.0,66916.15,401496.88
2020-12-22,Transfer,0.0,100374.22,301122.66
2020-12-22,Debit Card,0.0,37640.33,263482.33
2020-12-22,Cash,0.0,32935.29,230547.04
2020-12-22,Tax,0.0,230547.04,0.0
2020-12-22,Cash,40.38,0.0,40.38
2020-12-22,Miscellaneous,81952.0,0.0,81992.38
2020-12-22,Cash,0.0,16398.48,65593.9
2020-12-22,Interest,0.0,8199.24,57394.66
2020-12-22,Tax,0.0,5739.47,51655.19
2020-12-23,IMPS,0.0,10331.04,41324.15
2020-12-23,Cash,372.0,0.0,41696.15
2020-12-23,Debit Card,0.0,5212.02,36484.13
2020-12-23,Cash,0.0,4053.79,32430.34
2020-12-23,IMPS,0.0,10810.11,21620.23
2020-12-23,Bill,127868.75,0.0,149488.98
2020-12-23,Miscellaneous,27339.7,0.0,176828.68
2020-12-23,Commission,50830.28,0.0,227658.96
2020-12-23,Commission,0.0,37943.16,189715.8
2020-12-23,NEFT,8096.0,0.0,197811.8
2020-12-23,RTGS,32582.0,0.0,230393.8
2020-12-23,Interest,0.0,46078.76,184315.04
2020-12-23,RTGS,205.47,0.0,184520.51
2020-12-23,IMPS,0.0,18452.05,166068.46
2020-12-23,Cash,30463.0,0.0,196531.46
2020-12-23,Cash,55.1,0.0,196586.56
2020-12-23,IMPS,191791.2,0.0,388377.76
2020-12-23,Interest,1762.7,0.0,390140.46
2020-12-23,Debit Card,140595.44,0.0,530735.9
2020-12-24,Reversal,1973.0,0.0,532708.9
2020-12-24,Transfer,0.0,66588.61,466120.29
2020-12-24,Transfer,665992.75,0.0,1132113.04
2020-12-24,Miscellaneous,108387.0,0.0,1240500.04
2020-12-25,Bill,0.0,620250.02,620250.02
2020-12-25,NEFT,15581.75,0.0,635831.77
2020-12-25,Commission,2001052.0,0.0,2636883.77
2020-12-25,Tax,761905.5,0.0,3398789.27
2020-12-25,Interest,37.8,0.0,3398827.07
2020-12-25,Tax,0.0,566471.18,2832355.89
2020-12-25,NEFT,0.0,314706.21,2517649.68
2020-12-25,Commission,0.0,279738.85,2237910.83
2020-12-25,Reversal,0.0,559477.71,1678433.12
2020-12-25,Cheque,0.0,209804.14,1468628.98
2020-12-25,Interest,9459.0,0.0,1478087.98
2020-12-25,Interest,0.0,184761.0,1293326.98
2020-12-25,IMPS,218344.91,0.0,1511671.89
2020-12-25,Interest,157.28,0.0,1511829.17
2020-12-25,Transfer,0.0,377957.29,1133871.88
2020-12-25,IMPS,0.0,377957.29,755914.59
2020-12-25,Reversal,10.0,0.0,755924.59
2020-12-25,Cash,5.7,0.0,755930.29
2020-12-25,Cheque,235.2,0.0,756165.49
2020-12-25,RTGS,22.6,0.0,756188.09
2020-12-25,Transfer,239.84,0.0,756427.93
2020-12-25,Cash,0.0,756427.93,0.0
2020-12-25,Cash,28565.42,0.0,28565.42
2020-12-25,IMPS,0.0,4760.9,23804.52
2020-12-25,Tax,1976.22,0.0,25780.74
2020-12-25,IMPS,0.0,3222.59,22558.15
2020-12-25,Purchase,85.0,0.0,22643.15
2020-12-25,Debit Card,0.0,11321.58,11321.58
2020-12-25,Cash,312.0,0.0,11633.58
2020-12-25,Cash,2538.74,0.0,14172.32
2020-12-25,Interest,24526.51,0.0,38698.83
2020-12-25,Bill,0.0,38698.83,0.0
2020-12-25,IMPS,1777.17,0.0,1777.17
2020-12-25,Cheque,42.4,0.0,1819.57
2020-12-25,ATM,1459.85,0.0,3279.42
2020-12-25,IMPS,0.0,364.38,2915.04
2020-12-25,NEFT,1.74,0.0,2916.78
2020-12-25,Purchase,0.0,2916.78,0.0
2020-12-25,Interest,1160294.75,0.0,1160294.75
2020-12-25,IMPS,1260868.0,0.0,2421162.75
2020-12-25,IMPS,843452.2,0.0,3264614.95
2020-12-25,Cheque,927.0,0.0,3265541.95
2020-12-25,NEFT,0.0,1088513.98,2177027.97
2020-12-25,Interest,2413.3,0.0,2179441.27
2020-12-25,Tax,27611.91,0.0,2207053.18
2020-12-25,Reversal,0.0,275881.65,1931171.53
2020-12-25,NEFT,0.0,965585.77,965585.76
2020-12-25,Transfer,0.0,107287.31,858298.45
2020-12-25,RTGS,0.19,0.0,858298.64
2020-12-25,Debit Card,0.0,122614.09,735684.55
2020-12-25,NEFT,7833.0,0.0,743517.55
2020-12-25,Purchase,0.0,92939.69,650577.86
2020-12-25,Miscellaneous,0.0,65057.79,585520.07
2020-12-25,Commission,0.0,73190.01,512330.06
2020-12-25,RTGS,16181.8,0.0,528511.86
2020-12-25,ATM,0.0,528511.86,0.0
2020-12-25,Bill,11.9,0.0,11.9
2020-12-25,Debit Card,0.0,2.98,8.93
2020-12-25,Transfer,0.0,8.93,0.0
2020-12-25,Miscellaneous,507.3,0.0,507.3
2020-12-25,Tax,0.0,169.1,338.2
2020-12-25,Miscellaneous,0.0,37.58,300.62
2020-12-25,Tax,0.0,300.62,0.0
2020-12-25,Miscellaneous,1743.89,0.0,1743.89
2020-12-25,Miscellaneous,53998.0,0.0,55741.89
2020-12-25,IMPS,3.0,0.0,55744.89
2020-12-25,Cash,358.9,0.0,56103.79
2020-12-25,RTGS,3.0,0.0,56106.79
2020-12-25,Interest,0.0,7013.35,49093.44
2020-12-25,Debit Card,0.0,8182.24,40911.2
2020-12-25,Bill,0.0,13637.07,27274.13
2020-12-25,NEFT,0.0,3896.3,23377.83
2020-12-25,Miscellaneous,59.45,0.0,23437.28
2020-12-25,NEFT,0.0,3906.21,19531.07
2020-12-25,Commission,1243.4,0.0,20774.47
2020-12-25,Transfer,329720.0,0.0,350494.47
2020-12-25,Debit Card,0.0,70098.89,280395.58
2020-12-25,RTGS,71752.12,0.0,352147.7
2020-12-25,Debit Card,48.86,0.0,352196.56
2020-12-25,Tax,149822.31,0.0,502018.87
2020-12-25,NEFT,4.26,0.0,502023.13
2020-12-25,Bill,0.0,251011.57,251011.56
2020-12-25,Tax,3.0,0.0,251014.56
2020-12-25,RTGS,1593229.5,0.0,1844244.06
2020-12-25,ATM,2612.0,0.0,1846856.06
2020-12-25,IMPS,426.0,0.0,1847282.06
2020-12-25,IMPS,0.0,307880.34,1539401.72
2020-12-25,Commission,2.3,0.0,1539404.02
2020-12-25,Transfer,0.0,192425.5,1346978.52
2020-12-25,Cash,0.0,448992.84,897985.68
2020-12-25,Commission,0.0,179597.14,718388.54
2020-12-25,NEFT,0.0,71838.85,646549.69
2020-12-25,Purchase,0.0,71838.85,574710.84
2020-12-25,NEFT,8981.0,0.0,583691.84
2020-12-25,Bill,58.0,0.0,583749.84
2020-12-25,Bill,42436.0,0.0,626185.84
2020-12-25,ATM,2613.76,0.0,628799.6
2020-12-25,Commission,3.1,0.0,628802.7
2020-12-25,ATM,0.0,78600.34,550202.36
2020-12-25,Reversal,0.0,78600.34,471602.02
2020-12-25,Miscellaneous,0.0,52400.22,419201.8
2020-12-25,NEFT,29345.55,0.0,448547.35
2020-12-25,Tax,413.29,0.0,448960.64
2020-12-26,NEFT,0.0,56120.08,392840.56
2020-12-26,IMPS,339.7,0.0,393180.26
2020-12-27,NEFT,4.78,0.0,393185.04
2020-12-27,Cheque,0.0,131061.68,262123.36
2020-12-27,Cheque,0.0,131061.68,131061.68
2020-12-27,Purchase,18200.0,0.0,149261.68
2020-12-27,NEFT,0.0,49753.89,99507.79
2020-12-27,NEFT,3.47,0.0,99511.26
2020-12-27,Debit Card,0.0,0.0,99511.26
2020-12-27,Debit Card,915154.0,0.0,1014665.26
2020-12-27,Tax,42340.0,0.0,1057005.26
2020-12-27,Transfer,0.0,176167.54,880837.72
2020-12-27,Transfer,473.93,0.0,881311.65
2020-12-27,Bill,3.0,0.0,881314.65
2020-12-27,Interest,6.14,0.0,881320.79
2020-12-28,Tax,0.0,110165.1,771155.69
2020-12-28,Reversal,0.0,771155.69,0.0
2020-12-28,Purchase,3454.0,0.0,3454.0
2020-12-28,Reversal,0.0,3454.0,0.0
2020-12-28,Interest,701.7,0.0,701.7
2020-12-28,Reversal,5.47,0.0,707.17
2020-12-29,Tax,0.0,101.02,606.15
2020-12-29,NEFT,1071365.0,0.0,1071971.15
2020-12-29,NEFT,0.0,535985.58,535985.57
2020-12-29,RTGS,0.0,535985.57,0.0
2020-12-30,Commission,688.47,0.0,688.47
2020-12-30,Debit Card,110938.0,0.0,111626.47
2020-12-31,NEFT,0.0,37208.82,74417.65
2020-12-31,ATM,26.48,0.0,74444.13
2020-12-31,Tax,74304.16,0.0,148748.29
2020-12-31,Tax,0.0,18593.54,130154.75
2020-12-31,Purchase,0.0,14461.64,115693.11
2020-12-31,Cheque,3179.1,0.0,118872.21
2020-12-31,NEFT,0.0,29718.05,89154.16
2020-12-31,Miscellaneous,32413.09,0.0,121567.25
2020-12-31,Reversal,0.0,13507.47,108059.78
2020-12-31,Reversal,0.0,27014.95,81044.83
2020-12-31,Bill,61109.0,0.0,142153.83
2020-12-31,Cheque,113982.0,0.0,256135.83
2021-01-01,Purchase,193086.6,0.0,449222.43
2021-01-01,Cheque,0.0,449222.43,0.0
2021-01-01,Interest,1989.71,0.0,1989.71
2021-01-01,Cheque,0.0,198.97,1790.74
2021-01-01,Cheque,126449.0,0.0,128239.74
2021-01-01,Reversal,0.0,12823.97,115415.77
2021-01-01,Commission,0.0,14426.97,100988.8
2021-01-01,Commission,143.0,0.0,101131.8
2021-01-01,IMPS,0.0,11236.87,89894.93
2021-01-01,Debit Card,60.29,0.0,89955.22
2021-01-01,Cheque,9707.0,0.0,99662.22
2021-01-01,Cash,22607.0,0.0,122269.22
2021-01-01,Purchase,0.0,13585.47,108683.75
2021-01-01,Purchase,260618.44,0.0,369302.19
2021-01-01,Commission,0.0,92325.55,276976.64
2021-01-01,Purchase,0.0,69244.16,207732.48
2021-01-01,IMPS,0.0,41546.5,166185.98
2021-01-01,ATM,1770190.0,0.0,1936375.98
2021-01-01,Purchase,473.0,0.0,1936848.98
2021-01-01,ATM,7.0,0.0,1936855.98
2021-01-01,Cash,29136.3,0.0,1965992.28
2021-01-01,IMPS,109853.0,0.0,2075845.28
2021-01-01,Purchase,1818521.0,0.0,3894366.28
2021-01-01,Cheque,3894.0,0.0,3898260.28
2021-01-01,Debit Card,0.0,1299420.09,2598840.19
2021-01-01,RTGS,22.36,0.0,2598862.55
2021-01-01,Purchase,3100.6,0.0,2601963.15
2021-01-01,Transfer,0.0,433660.53,2168302.62
2021-01-01,Reversal,0.0,240922.51,1927380.11
2021-01-01,Debit Card,0.0,385476.02,1541904.09
2021-01-01,Cheque,0.0,513968.03,1027936.06
2021-01-01,Purchase,0.0,146848.01,881088.05
2021-01-01,Tax,0.0,97898.67,783189.38
2021-01-02,NEFT,10275.91,0.0,793465.29
2021-01-02,Commission,220.5,0.0,793685.79
2021-01-02,RTGS,178914.0,0.0,972599.79
2021-01-02,RTGS,129.0,0.0,972728.79
2021-01-02,Reversal,0.0,138961.26,833767.53
2021-01-02,Bill,351.34,0.0,834118.87
2021-01-02,NEFT,34751.88,0.0,868870.75
2021-01-02,Transfer,0.0,144811.79,724058.96
2021-01-02,IMPS,431.1,0.0,724490.06
2021-01-02,NEFT,7.0,0.0,724497.06
2021-01-02,Tax,1718922.0,0.0,2443419.06
2021-01-02,Miscellaneous,144.9,0.0,2443563.96
2021-01-02,Transfer,5.0,0.0,2443568.96
2021-01-02,Commission,209665.0,0.0,2653233.96
2021-01-02,Miscellaneous,0.0,442205.66,2211028.3
2021-01-02,Bill,20728.39,0.0,2231756.69
2021-01-02,Bill,0.0,743918.9,1487837.79
2021-01-02,ATM,0.0,1487837.79,0.0
2021-01-02,Interest,2450.0,0.0,2450.0
2021-01-02,IMPS,2061.6,0.0,4511.6
2021-01-02,Miscellaneous,0.0,902.32,3609.28
2021-01-02,RTGS,660785.25,0.0,664394.53
2021-01-02,NEFT,692.96,0.0,665087.49
2021-01-02,Cheque,1224926.8,0.0,1890014.29
2021-01-03,Debit Card,16.87,0.0,1890031.16
2021-01-03,Miscellaneous,4.93,0.0,1890036.09
2021-01-03,Debit Card,0.0,189003.61,1701032.48
2021-01-03,Reversal,0.0,189003.61,1512028.87
2021-01-03,RTGS,17.6,0.0,1512046.47
2021-01-03,Tax,0.0,504015.49,1008030.98
2021-01-03,Purchase,0.0,168005.16,840025.82
2021-01-03,IMPS,17.0,0.0,840042.82
2021-01-03,RTGS,0.0,120006.12,720036.7
2021-01-03,ATM,0.0,720036.7,0.0
2021-01-03,Interest,6.0,0.0,6.0
2021-01-04,Cheque,0.0,0.67,5.33
2021-01-05,Interest,0.0,0.76,4.57
2021-01-05,Interest,3471.0,0.0,3475.57
2021-01-05,Miscellaneous,0.0,695.11,2780.46
2021-01-05,RTGS,25272.0,0.0,28052.46
2021-01-05,NEFT,1875.0,0.0,29927.46
2021-01-05,Miscellaneous,824.0,0.0,30751.46
2021-01-05,Cash,0.0,10250.49,20500.97
2021-01-05,Interest,0.0,6833.66,13667.31
2021-01-05,Transfer,9644.05,0.0,23311.36
2021-01-05,NEFT,167284.41,0.0,190595.77
2021-01-05,Debit Card,0.0,21177.31,169418.46
2021-01-05,Reversal,0.0,33883.69,135534.77
2021-01-05,IMPS,8.93,0.0,135543.7
2021-01-05,RTGS,0.0,45181.23,90362.47
2021-01-05,Cash,0.0,30120.82,60241.65
2021-01-05,Commission,0.0,6693.52,53548.13
2021-01-05,Interest,0.0,26774.07,26774.06
2021-01-05,Cheque,24.0,0.0,26798.06
2021-01-05,Transfer,0.0,13399.03,13399.03
2021-01-05,ATM,1570038.8,0.0,1583437.83
2021-01-05,Miscellaneous,0.0,527812.61,1055625.22
2021-01-05,Cheque,349.0,0.0,1055974.22
2021-01-05,ATM,0.0,105597.42,950376.8
2021-01-05,Bill,0.0,105597.42,844779.38
2021-01-05,Commission,4.1,0.0,844783.48
2021-01-05,ATM,160879.2,0.0,1005662.68
2021-01-05,Tax,7.3,0.0,1005669.98
2021-01-05,IMPS,2562.12,0.0,1008232.1
2021-01-05,RTGS,1467818.0,0.0,2476050.1
2021-01-05,Purchase,0.06,0.0,2476050.16
2021-01-05,Purchase,41.0,0.0,2476091.16
2021-01-05,Bill,53.26,0.0,2476144.42
2021-01-05,ATM,1698885.5,0.0,4175029.92
2021-01-05,Transfer,0.0,417502.99,3757526.93
2021-01-05,RTGS,27686.7,0.0,3785213.63
2021-01-05,Cash,0.9,0.0,3785214.53
2021-01-05,Bill,0.0,630869.09,3154345.44
2021-01-05,Commission,0.0,1577172.72,1577172.72
2021-01-05,Cash,0.0,225310.39,1351862.33
2021-01-05,Bill,0.0,270372.47,1081489.86
2021-01-05,NEFT,0.0,135186.23,946303.63
2021-01-05,Cheque,0.0,135186.23,811117.4
2021-01-05,Miscellaneous,0.0,811117.4,0.0
2021-01-05,Commission,33.7,0.0,33.7
2021-01-05,NEFT,72.86,0.0,106.56
2021-01-05,Cheque,540286.25,0.0,540392.81
2021-01-05,Transfer,293.9,0.0,540686.71
2021-01-05,Bill,36.0,0.0,540722.71
2021-01-05,Purchase,0.0,108144.54,432578.17
2021-01-05,Debit Card,0.0,48064.24,384513.93
2021-01-05,Cheque,3023.0,0.0,387536.93
2021-01-05,ATM,0.0,77507.39,310029.54
2021-01-05,Purchase,0.0,155014.77,155014.77
2021-01-05,Commission,2896.45,0.0,157911.22
2021-01-05,Reversal,1777.0,0.0,159688.22
2021-01-05,Reversal,3.72,0.0,159691.94
2021-01-05,Interest,1974280.0,0.0,2133971.94
2021-01-05,Cash,0.0,426794.39,1707177.55
2021-01-05,Commission,0.0,284529.59,1422647.96
2021-01-05,Cash,0.0,177831.0,1244816.96
2021-01-05,Transfer,0.0,311204.24,933612.72
2021-01-05,Tax,0.0,466806.36,466806.36
2021-01-05,Tax,0.0,116701.59,350104.77
2021-01-06,Reversal,152957.0,0.0,503061.77
2021-01-06,Transfer,0.0,55895.75,447166.02
2021-01-06,Debit Card,0.0,49685.11,397480.91
2021-01-06,Tax,0.0,132493.64,264987.27
2021-01-07,Bill,0.0,66246.82,198740.45
2021-01-07,Debit Card,0.0,22082.27,176658.18
2021-01-07,Bill,1794.59,0.0,178452.77
2021-01-07,Cash,0.0,22306.6,156146.17
2021-01-07,Cash,160413.72,0.0,316559.89
2021-01-07,Bill,0.0,35173.32,281386.57
2021-01-07,Reversal,0.0,46897.76,234488.81
2021-01-07,Debit Card,0.0,29311.1,205177.71
2021-01-07,ATM,47.78,0.0,205225.49
2021-01-07,Transfer,0.0,205225.49,0.0
2021-01-07,Reversal,6.0,0.0,6.0
2021-01-07,NEFT,2.9,0.0,8.9
2021-01-07,RTGS,2048.2,0.0,2057.1
2021-01-07,Cheque,0.0,205.71,1851.39
2021-01-07,RTGS,176.0,0.0,2027.39
2021-01-07,Cheque,1233779.0,0.0,1235806.39
2021-01-07,Commission,0.0,247161.28,988645.11
2021-01-07,Interest,1155076.5,0.0,2143721.61
2021-01-07,Reversal,0.0,428744.32,1714977.29
2021-01-07,Reversal,0.0,1714977.29,0.0
2021-01-07,IMPS,29.0,0.0,29.0
2021-01-07,Debit Card,0.0,7.25,21.75
2021-01-07,Transfer,0.0,10.88,10.88
2021-01-07,Tax,1.1,0.0,11.98
2021-01-08,IMPS,0.0,3.99,7.99
2021-01-08,Interest,52299.0,0.0,52306.99
2021-01-08,NEFT,84.6,0.0,52391.59
2021-01-08,Commission,0.0,5239.16,47152.43
2021-01-08,RTGS,0.0,4715.24,42437.19
2021-01-08,Miscellaneous,15884.0,0.0,58321.19
2021-01-08,Commission,0.0,19440.4,38880.79
2021-01-08,ATM,1.86,0.0,38882.65
2021-01-08,Reversal,568882.75,0.0,607765.4
2021-01-08,Tax,0.0,607765.4,0.0
2021-01-08,Cheque,26415.1,0.0,26415.1
2021-01-08,Debit Card,30.0,0.0,26445.1
2021-01-09,Interest,0.0,4407.52,22037.58
2021-01-09,Interest,50145.44,0.0,72183.02
2021-01-09,RTGS,875.0,0.0,73058.02
2021-01-09,IMPS,0.0,7305.8,65752.22
2021-01-09,Reversal,3339.24,0.0,69091.46
2021-01-09,RTGS,19914.1,0.0,89005.56
2021-01-09,Purchase,0.0,17801.11,71204.45
2021-01-09,Transfer,22.4,0.0,71226.85
2021-01-09,Cheque,24.56,0.0,71251.41
2021-01-09,Cheque,13159.0,0.0,84410.41
2021-01-09,Interest,24558.3,0.0,108968.71
2021-01-09,Miscellaneous,247.0,0.0,109215.71
2021-01-09,Reversal,0.0,21843.14,87372.57
2021-01-09,NEFT,0.0,21843.14,65529.43
2021-01-09,Miscellaneous,0.0,9361.35,56168.08
2021-01-09,Transfer,3.9,0.0,56171.98
2021-01-10,Interest,0.0,9362.0,46809.98
2021-01-10,Interest,0.0,11702.5,35107.48
2021-01-10,Commission,453.7,0.0,35561.18
2021-01-10,Transfer,123936.1,0.0,159497.28
2021-01-10,Reversal,0.0,159497.28,0.0
2021-01-10,Purchase,244914.0,0.0,244914.0
2021-01-10,Debit Card,428.94,0.0,245342.94
2021-01-10,Commission,0.23,0.0,245343.17
2021-01-10,IMPS,0.0,40890.53,204452.64
2021-01-10,Interest,0.0,34075.44,170377.2
2021-01-10,Reversal,0.0,18930.8,151446.4
2021-01-10,Transfer,44.0,0.0,151490.4
2021-01-10,Reversal,0.0,25248.4,126242.0
2021-01-10,Reversal,323.77,0.0,126565.77
2021-01-10,Transfer,14944.25,0.0,141510.02
2021-01-10,IMPS,857282.0,0.0,998792.02
2021-01-10,RTGS,0.0,998792.02,0.0
2021-01-10,Cash,39.0,0.0,39.0
2021-01-10,Bill,2.07,0.0,41.07
2021-01-10,RTGS,0.0,20.54,20.54
2021-01-10,Cash,0.0,4.11,16.43
2021-01-10,NEFT,0.0,2.74,13.69
2021-01-10,Commission,577606.25,0.0,577619.94
2021-01-10,Miscellaneous,19.0,0.0,577638.94
2021-01-10,NEFT,0.0,57763.89,519875.05
2021-01-10,NEFT,0.0,74267.86,445607.19
2021-01-10,Interest,0.0,55700.9,389906.29
2021-01-10,NEFT,0.0,194953.15,194953.14
2021-01-10,Cheque,0.0,64984.38,129968.76
2021-01-10,Reversal,6434.82,0.0,136403.58
2021-01-10,Reversal,1.88,0.0,136405.46
2021-01-10,Transfer,0.0,22734.24,113671.22
2021-01-10,Miscellaneous,4.4,0.0,113675.62
2021-01-10,ATM,0.0,12630.62,101045.0
2021-01-11,RTGS,13963.0,0.0,115008.0
2021-01-11,Purchase,0.0,38336.0,76672.0
2021-01-11,Tax,6.2,0.0,76678.2
2021-01-11,Cheque,0.0,8519.8,68158.4
2021-01-11,Transfer,7.2,0.0,68165.6
2021-01-11,IMPS,124292.5,0.0,192458.1
2021-01-11,Cheque,0.0,64152.7,128305.4
2021-01-11,Debit Card,21222.59,0.0,149527.99
2021-01-11,Transfer,252.4,0.0,149780.39
2021-01-11,Bill,0.0,49926.8,99853.59
2021-01-11,RTGS,39.4,0.0,99892.99
2021-01-11,Purchase,268.2,0.0,100161.19
2021-01-11,Debit Card,0.0,12520.15,87641.04
2021-01-11,Reversal,0.0,21910.26,65730.78
2021-01-11,IMPS,192646.72,0.0,258377.5
2021-01-11,Cash,0.0,28708.61,229668.89
2021-01-11,Transfer,0.0,45933.78,183735.11
2021-01-11,Debit Card,62200.6,0.0,245935.71
2021-01-11,Interest,31.9,0.0,245967.61
2021-01-11,ATM,0.0,35138.23,210829.38
2021-01-11,RTGS,7.0,0.0,210836.38
2021-01-11,Commission,7.0,0.0,210843.38
2021-01-11,Interest,256439.0,0.0,467282.38
2021-01-11,Purchase,0.0,116820.6,350461.78
2021-01-11,ATM,9.7,0.0,350471.48
2021-01-11,Reversal,0.0,70094.3,280377.18
2021-01-11,Debit Card,314.09,0.0,280691.27
2021-01-11,NEFT,29668.0,0.0,310359.27
2021-01-11,Cash,0.0,77589.82,232769.45
2021-01-11,Tax,42.0,0.0,232811.45
2021-01-11,Tax,10.95,0.0,232822.4
2021-01-11,IMPS,0.0,46564.48,186257.92
2021-01-11,Commission,4.1,0.0,186262.02
2021-01-11,Cheque,1380.0,0.0,187642.02
2021-01-11,Bill,64598.6,0.0,252240.62
2021-01-11,Cheque,0.0,252240.62,0.0
2021-01-11,Tax,488.1,0.0,488.1
2021-01-11,ATM,64.0,0.0,552.1
2021-01-11,RTGS,0.0,69.01,483.09
2021-01-11,Reversal,339.06,0.0,822.15
2021-01-11,Transfer,0.0,91.35,730.8
2021-01-11,Miscellaneous,0.0,81.2,649.6
2021-01-11,NEFT,0.0,129.92,519.68
2021-01-11,Cash,387128.5,0.0,387648.18
2021-01-11,ATM,0.0,38764.82,348883.36
2021-01-11,IMPS,174706.0,0.0,523589.36
2021-01-11,Transfer,0.0,104717.87,418871.49
2021-01-11,Cash,163682.4,0.0,582553.89
2021-01-11,RTGS,0.0,83221.98,499331.91
2021-01-11,Debit Card,0.0,49933.19,449398.72
2021-01-11,RTGS,4.9,0.0,449403.62
2021-01-11,Cheque,0.0,56175.45,393228.17
2021-01-11,NEFT,0.0,43692.02,349536.15
2021-01-11,IMPS,0.0,349536.15,0.0
2021-01-11,NEFT,1.51,0.0,1.51
2021-01-11,RTGS,182.2,0.0,183.71
2021-01-11,Miscellaneous,0.0,26.24,157.47
2021-01-11,Purchase,0.0,15.75,141.72
2021-01-11,Reversal,1003.0,0.0,1144.72
2021-01-11,NEFT,13.14,0.0,1157.86
2021-01-11,ATM,0.0,231.57,926.29
2021-01-11,Tax,0.0,115.79,810.5
2021-01-11,Purchase,0.0,405.25,405.25
2021-01-11,Reversal,0.0,405.25,0.0
2021-01-11,Purchase,466.6,0.0,466.6
2021-01-11,NEFT,2.9,0.0,469.5
2021-01-11,IMPS,0.0,234.75,234.75
2021-01-11,Cash,2206.0,0.0,2440.75
2021-01-11,Commission,116.8,0.0,2557.55
2021-01-12,Cheque,712148.0,0.0,714705.55
2021-01-12,IMPS,0.0,79411.73,635293.82
2021-01-12,Tax,19.0,0.0,635312.82
2021-01-12,Bill,5.4,0.0,635318.22
2021-01-12,Bill,2.35,0.0,635320.57
2021-01-12,Cheque,17274.0,0.0,652594.57
2021-01-12,ATM,1701008.5,0.0,2353603.07
2021-01-12,Miscellaneous,6.9,0.0,2353609.97
2021-01-12,Purchase,82473.25,0.0,2436083.22
2021-01-12,IMPS,473.4,0.0,2436556.62
2021-01-12,ATM,0.0,304569.58,2131987.04
2021-01-12,Tax,1866.4,0.0,2133853.44
2021-01-12,NEFT,0.0,213385.34,1920468.1
2021-01-12,Cash,0.0,320078.02,1600390.08
2021-01-12,Purchase,1549.95,0.0,1601940.03
2021-01-12,Miscellaneous,0.0,533980.01,1067960.02
2021-01-12,IMPS,0.0,266990.01,800970.02
2021-01-12,Tax,11215.7,0.0,812185.72
2021-01-13,Reversal,702209.5,0.0,1514395.22
2021-01-13,Bill,391.77,0.0,1514786.99
2021-01-13,Transfer,0.0,302957.4,1211829.59
2021-01-13,Transfer,0.0,121182.96,1090646.63
2021-01-13,Purchase,1774012.5,0.0,2864659.13
2021-01-13,Cheque,62.32,0.0,2864721.45
2021-01-13,Commission,7599.0,0.0,2872320.45
2021-01-13,RTGS,2.4,0.0,2872322.85
2021-01-13,Bill,97027.0,0.0,2969349.85
2021-01-13,RTGS,183.0,0.0,2969532.85
2021-01-13,Miscellaneous,266337.0,0.0,3235869.85
2021-01-13,Tax,184.0,0.0,3236053.85
2021-01-13,Interest,0.0,3236053.85,0.0
2021-01-13,ATM,62.9,0.0,62.9
2021-01-13,Commission,0.0,20.97,41.93
2021-01-13,IMPS,8410.0,0.0,8451.93
2021-01-13,Cash,2.46,0.0,8454.39
2021-01-13,Purchase,1575869.25,0.0,1584323.64
2021-01-13,RTGS,0.0,226331.95,1357991.69
2021-01-13,Tax,0.0,135799.17,1222192.52
2021-01-13,Tax,321768.0,0.0,1543960.52
2021-01-13,Debit Card,9.0,0.0,1543969.52
2021-01-13,NEFT,414.0,0.0,1544383.52
2021-01-13,Cheque,0.0,154438.35,1389945.17
2021-01-13,Purchase,0.0,154438.35,1235506.82
2021-01-13,RTGS,185612.41,0.0,1421119.23
2021-01-13,ATM,577.65,0.0,1421696.88
2021-01-13,IMPS,289009.0,0.0,1710705.88
2021-01-13,Cash,0.0,342141.18,1368564.7
2021-01-13,ATM,2401.32,0.0,1370966.02
2021-01-13,RTGS,17872.0,0.0,1388838.02
2021-01-13,Purchase,0.0,694419.01,694419.01
2021-01-13,Purchase,0.0,694419.01,0.0
2021-01-13,Transfer,32382.0,0.0,32382.0
2021-01-13,Miscellaneous,0.0,3598.0,28784.0
2021-01-13,NEFT,1498.9,0.0,30282.9
2021-01-13,Miscellaneous,18920.3,0.0,49203.2
2021-01-13,Commission,0.0,6150.4,43052.8
2021-01-14,Commission,0.0,10763.2,32289.6
2021-01-14,Debit Card,20.1,0.0,32309.7
2021-01-14,NEFT,5.6,0.0,32315.3
2021-01-14,NEFT,0.0,4616.47,27698.83
2021-01-14,Reversal,0.0,6924.71,20774.12
2021-01-14,Cash,131743.6,0.0,152517.72
2021-01-14,Commission,0.0,38129.43,114388.29
2021-01-14,Bill,0.0,57194.15,57194.14
2021-01-14,Cheque,16574.0,0.0,73768.14
2021-01-14,IMPS,0.0,9221.02,64547.12
2021-01-14,Interest,224.0,0.0,64771.12
2021-01-14,Bill,6.53,0.0,64777.65
2021-01-14,NEFT,0.0,12955.53,51822.12
2021-01-14,Commission,163032.34,0.0,214854.46
2021-01-14,Tax,0.0,21485.45,193369.01
2021-01-15,Purchase,0.0,24171.13,169197.88
2021-01-15,NEFT,2.52,0.0,169200.4
2021-01-15,Reversal,548.3,0.0,169748.7
2021-01-15,ATM,1769243.5,0.0,1938992.2
2021-01-15,Purchase,0.0,969496.1,969496.1
2021-01-15,Interest,40676.62,0.0,1010172.72
2021-01-15,Miscellaneous,0.0,1010172.72,0.0
2021-01-15,Cash,44.0,0.0,44.0
2021-01-15,Reversal,5.7,0.0,49.7
2021-01-15,Purchase,3.9,0.0,53.6
2021-01-15,Interest,0.0,10.72,42.88
2021-01-15,ATM,2.3,0.0,45.18
2021-01-15,Reversal,689441.25,0.0,689486.43
2021-01-15,ATM,0.0,86185.8,603300.63
2021-01-15,Cash,745934.75,0.0,1349235.38
2021-01-15,Debit Card,0.0,674617.69,674617.69
2021-01-15,Cheque,1610.8,0.0,676228.49
2021-01-15,RTGS,30565.6,0.0,706794.09
2021-01-15,NEFT,0.0,70679.41,636114.68
2021-01-15,Bill,0.0,63611.47,572503.21
2021-01-16,Interest,25.8,0.0,572529.01
2021-01-16,Interest,0.0,63614.33,508914.68
2021-01-16,Debit Card,0.0,127228.67,381686.01
2021-01-16,Cash,1.72,0.0,381687.73
2021-01-16,Interest,1753.3,0.0,383441.03
2021-01-16,Tax,6.61,0.0,383447.64
2021-01-16,Miscellaneous,5268.97,0.0,388716.61
2021-01-16,Cash,3.53,0.0,388720.14
2021-01-16,RTGS,0.0,55531.45,333188.69
2021-01-16,Tax,0.0,166594.35,166594.34
2021-01-16,ATM,659.0,0.0,167253.34
2021-01-16,Commission,0.0,16725.33,150528.01
2021-01-16,Reversal,0.0,18816.0,131712.01
2021-01-16,ATM,0.0,21952.0,109760.01
2021-01-16,Purchase,0.0,27440.0,82320.01
2021-01-16,Reversal,774259.5,0.0,856579.51
2021-01-16,Bill,0.0,171315.9,685263.61
2021-01-16,Bill,1626877.0,0.0,2312140.61
2021-01-16,Transfer,0.0,2312140.61,0.0
2021-01-16,NEFT,26748.0,0.0,26748.0
2021-01-16,Tax,0.0,6687.0,20061.0
2021-01-16,IMPS,0.0,2229.0,17832.0
2021-01-16,Transfer,0.0,1783.2,16048.8
2021-01-16,Bill,48.3,0.0,16097.1
2021-01-16,Transfer,50.1,0.0,16147.2
2021-01-16,RTGS,0.0,1614.72,14532.48
2021-01-16,ATM,1324519.0,0.0,1339051.48
2021-01-16,Miscellaneous,656068.0,0.0,1995119.48
2021-01-16,Tax,0.0,249389.94,1745729.54
2021-01-16,RTGS,0.0,249389.93,1496339.61
2021-01-16,Tax,0.0,149633.96,1346705.65
2021-01-16,IMPS,27072.5,0.0,1373778.15
2021-01-16,Tax,16481.49,0.0,1390259.64
2021-01-16,IMPS,78077.0,0.0,1468336.64
2021-01-16,Interest,0.0,183542.08,1284794.56
2021-01-16,NEFT,0.0,321198.64,963595.92
2021-01-16,Cash,0.0,137656.56,825939.36
2021-01-16,IMPS,0.0,82593.94,743345.42
2021-01-16,Transfer,230135.97,0.0,973481.39
2021-01-16,Debit Card,0.0,973481.39,0.0
2021-01-16,Transfer,3740.0,0.0,3740.0
2021-01-16,RTGS,4.0,0.0,3744.0
2021-01-17,Bill,0.0,936.0,2808.0
2021-01-17,Miscellaneous,2045424.5,0.0,2048232.5
2021-01-17,Miscellaneous,0.0,256029.06,1792203.44
2021-01-17,Miscellaneous,0.0,448050.86,1344152.58
2021-01-17,Commission,23.0,0.0,1344175.58
2021-01-17,IMPS,0.0,448058.53,896117.05
2021-01-17,RTGS,0.0,149352.84,746764.21
2021-01-17,Bill,0.0,93345.53,653418.68
2021-01-17,IMPS,29980.9,0.0,683399.58
2021-01-17,Commission,0.0,97628.51,585771.07
2021-01-17,Cash,0.0,195257.02,390514.05
2021-01-18,Purchase,29.74,0.0,390543.79
2021-01-18,Cheque,0.0,97635.95,292907.84
2021-01-18,RTGS,14.16,0.0,292922.0
2021-01-18,Cheque,0.0,146461.0,146461.0
2021-01-18,Purchase,896.0,0.0,147357.0
2021-01-18,Cash,60.39,0.0,147417.39
2021-01-18,Cheque,0.0,16379.71,131037.68
2021-01-18,NEFT,21131.32,0.0,152169.0
2021-01-18,Bill,0.0,76084.5,76084.5
2021-01-18,Transfer,0.0,38042.25,38042.25
2021-01-18,NEFT,2.8,0.0,38045.05
2021-01-18,Interest,171774.9,0.0,209819.95
2021-01-18,IMPS,0.0,41963.99,167855.96
2021-01-18,Reversal,0.0,55951.99,111903.97
2021-01-18,Debit Card,995186.5,0.0,1107090.47
2021-01-18,NEFT,0.0,221418.09,885672.38
2021-01-18,Commission,1455628.0,0.0,2341300.38
2021-01-18,ATM,0.0,2341300.38,0.0
2021-01-18,Commission,2068.0,0.0,2068.0
2021-01-18,Commission,3.6,0.0,2071.6
2021-01-18,RTGS,0.0,517.9,1553.7
2021-01-18,Commission,7.8,0.0,1561.5
2021-01-18,Interest,178505.1,0.0,180066.6
2021-01-18,Cash,0.0,25723.8,154342.8
2021-01-18,Debit Card,0.0,30868.56,123474.24
2021-01-18,Cash,7.0,0.0,123481.24
2021-01-18,Cash,6.3,0.0,123487.54
2021-01-18,Miscellaneous,0.0,12348.75,111138.79
2021-01-18,Cash,0.0,12348.75,98790.04
2021-01-18,Purchase,0.0,24697.51,74092.53
2021-01-18,Tax,0.0,9261.57,64830.96
2021-01-18,Interest,0.0,21610.32,43220.64
2021-01-18,Miscellaneous,2.47,0.0,43223.11
2021-01-18,Tax,0.0,8644.62,34578.49
2021-01-18,Purchase,3.0,0.0,34581.49
2021-01-18,Reversal,146.96,0.0,34728.45
2021-01-18,Debit Card,8471.5,0.0,43199.95
2021-01-18,Commission,0.0,43199.95,0.0
2021-01-18,NEFT,3.0,0.0,3.0
2021-01-18,Interest,23190.0,0.0,23193.0
2021-01-18,Bill,25.0,0.0,23218.0
2021-01-18,Debit Card,0.0,11609.0,11609.0
2021-01-18,Cheque,79450.0,0.0,91059.0
2021-01-18,Tax,39.0,0.0,91098.0
2021-01-18,Bill,10.0,0.0,91108.0
2021-01-18,Cash,3310.7,0.0,94418.7
2021-01-18,Commission,0.0,23604.68,70814.02
2021-01-18,ATM,1441874.2,0.0,1512688.22
2021-01-18,Commission,0.0,189086.03,1323602.19
2021-01-18,Cash,0.0,441200.73,882401.46
2021-01-18,Transfer,0.0,441200.73,441200.73
2021-01-18,Interest,0.0,44120.07,397080.66
2021-01-18,IMPS,10175.23,0.0,407255.89
2021-01-18,RTGS,381.4,0.0,407637.29
2021-01-18,Transfer,3491.3,0.0,411128.59
2021-01-18,Transfer,0.0,411128.59,0.0
2021-01-18,Bill,15369.4,0.0,15369.4
2021-01-18,ATM,0.0,2195.63,13173.77
2021-01-18,Tax,51.4,0.0,13225.17
2021-01-18,Bill,1303131.25,0.0,1316356.42
2021-01-18,Commission,0.0,164544.55,1151811.87
2021-01-18,RTGS,721.7,0.0,1152533.57
2021-01-18,Interest,35134.8,0.0,1187668.37
2021-01-18,Cash,0.0,118766.84,1068901.53
2021-01-18,NEFT,126.0,0.0,1069027.53
2021-01-18,Purchase,0.0,1069027.53,0.0
2021-01-18,Bill,75.0,0.0,75.0
2021-01-18,Debit Card,3.0,0.0,78.0
2021-01-18,Miscellaneous,53.9,0.0,131.9
2021-01-18,Transfer,0.0,18.84,113.06
2021-01-19,NEFT,1776588.0,0.0,1776701.06
2021-01-19,Commission,2984.0,0.0,1779685.06
2021-01-19,ATM,0.0,177968.51,1601716.55
2021-01-19,Interest,3345.25,0.0,1605061.8
2021-01-19,Bill,0.0,321012.36,1284049.44
2021-01-19,IMPS,30180.9,0.0,1314230.34
2021-01-19,Reversal,26.5,0.0,1314256.84
2021-01-19,Transfer,4.0,0.0,1314260.84
2021-01-19,Miscellaneous,0.0,146028.98,1168231.86
2021-01-19,Reversal,0.0,1168231.86,0.0
2021-01-19,Debit Card,441.5,0.0,441.5
2021-01-20,ATM,0.0,110.38,331.12
2021-01-20,Bill,45431.69,0.0,45762.81
2021-01-20,Purchase,0.0,15254.27,30508.54
2021-01-20,Reversal,0.0,15254.27,15254.27
2021-01-20,RTGS,219.5,0.0,15473.77
2021-01-20,Cash,502520.5,0.0,517994.27
2021-01-20,Tax,0.0,57554.92,460439.35
2021-01-20,Cheque,0.0,153479.78,306959.57
2021-01-20,Commission,3.0,0.0,306962.57
2021-01-20,Cheque,140755.5,0.0,447718.07
2021-01-20,IMPS,386547.25,0.0,834265.32
2021-01-20,Bill,1321.18,0.0,835586.5
2021-01-20,Miscellaneous,327.0,0.0,835913.5
2021-01-20,Tax,796750.0,0.0,1632663.5
2021-01-20,NEFT,5496.8,0.0,1638160.3
2021-01-20,NEFT,0.0,163816.03,1474344.27
2021-01-20,Purchase,0.0,163816.03,1310528.24
2021-01-20,Cash,0.0,655264.12,655264.12
2021-01-20,Bill,24420.4,0.0,679684.52
2021-01-20,Reversal,5.8,0.0,679690.32
2021-01-20,Miscellaneous,2443.0,0.0,682133.32
2021-01-20,Reversal,0.0,75792.59,606340.73
2021-01-20,Debit Card,0.0,121268.15,485072.58
2021-01-20,ATM,0.0,60634.07,424438.51
2021-01-21,Purchase,0.0,47159.83,377278.68
2021-01-21,RTGS,16981.99,0.0,394260.67
2021-01-21,IMPS,472.0,0.0,394732.67
2021-01-21,Commission,0.0,39473.27,355259.4
2021-01-21,Cash,0.0,39473.27,315786.13
2021-01-21,IMPS,0.0,52631.02,263155.11
2021-01-21,Cheque,0.0,65788.78,197366.33
2021-01-21,Purchase,0.0,21929.59,175436.74
2021-01-21,RTGS,8.0,0.0,175444.74
2021-01-21,IMPS,0.0,21930.59,153514.15
2021-01-21,Miscellaneous,0.0,15351.42,138162.73
2021-01-22,Commission,24686.0,0.0,162848.73
2021-01-22,RTGS,202730.0,0.0,365578.73
2021-01-22,Reversal,0.0,60929.79,304648.94
2021-01-23,Miscellaneous,0.0,43521.28,261127.66
2021-01-23,NEFT,163073.0,0.0,424200.66
2021-01-23,Cheque,230372.7,0.0,654573.36
2021-01-23,ATM,41.0,0.0,654614.36
2021-01-23,Reversal,889227.0,0.0,1543841.36
2021-01-23,Cash,472629.0,0.0,2016470.36
2021-01-23,Purchase,1744793.0,0.0,3761263.36
2021-01-23,NEFT,73172.8,0.0,3834436.16
2021-01-23,Miscellaneous,342.9,0.0,3834779.06
2021-01-23,Interest,27080.0,0.0,3861859.06
2021-01-23,NEFT,0.0,772371.81,3089487.25
2021-01-23,Tax,1991.02,0.0,3091478.27
2021-01-23,Cheque,0.0,3091478.27,0.0
2021-01-23,Purchase,168173.38,0.0,168173.38
2021-01-23,ATM,18121.5,0.0,186294.88
2021-01-23,Interest,0.0,62098.29,124196.59
2021-01-23,Bill,0.0,17742.37,106454.22
2021-01-24,NEFT,0.0,26613.56,79840.67
2021-01-24,Cash,0.0,0.0,79840.67
2021-01-25,Bill,0.0,26613.56,53227.11
2021-01-25,Purchase,3203.2,0.0,56430.31
2021-01-25,ATM,2231.56,0.0,58661.87
2021-01-25,Cash,6.09,0.0,58667.96
2021-01-25,Interest,0.0,14666.99,44000.97
2021-01-25,RTGS,67267.28,0.0,111268.25
2021-01-25,Interest,0.0,27817.06,83451.19
2021-01-25,Miscellaneous,30396.87,0.0,113848.06
2021-01-25,Reversal,395.0,0.0,114243.06
2021-01-25,Tax,0.0,11424.31,102818.75
2021-01-25,Reversal,23861.36,0.0,126680.11
2021-01-25,ATM,271.0,0.0,126951.11
2021-01-25,Miscellaneous,0.0,18135.87,108815.24
2021-01-25,Tax,202.0,0.0,109017.24
2021-01-25,Transfer,0.0,36339.08,72678.16
2021-01-25,Tax,234631.72,0.0,307309.88
2021-01-25,Miscellaneous,71696.0,0.0,379005.88
2021-01-25,Miscellaneous,0.0,379005.88,0.0
2021-01-25,Cheque,961.0,0.0,961.0
2021-01-25,Debit Card,93.61,0.0,1054.61
2021-01-25,ATM,37.2,0.0,1091.81
2021-01-25,NEFT,12.31,0.0,1104.12
2021-01-25,IMPS,0.0,157.73,946.39
2021-01-25,Bill,7.0,0.0,953.39
2021-01-25,ATM,1600794.0,0.0,1601747.39
2021-01-25,NEFT,0.0,160174.74,1441572.65
2021-01-25,Interest,183.0,0.0,1441755.65
2021-01-25,Tax,77518.8,0.0,1519274.45
2021-01-25,Interest,5.59,0.0,1519280.04
2021-01-25,Commission,2.5,0.0,1519282.54
2021-01-25,NEFT,156842.0,0.0,1676124.54
2021-01-25,Miscellaneous,0.0,1676124.54,0.0
2021-01-25,Bill,241.5,0.0,241.5
2021-01-25,Tax,3.54,0.0,245.04
2021-01-25,Reversal,5.11,0.0,250.15
2021-01-25,Interest,2835.0,0.0,3085.15
2021-01-25,Miscellaneous,28460.7,0.0,31545.85
2021-01-25,Miscellaneous,2337.0,0.0,33882.85
2021-01-25,RTGS,11.4,0.0,33894.25
2021-01-25,NEFT,0.0,3389.43,30504.82
2021-01-25,Cheque,0.0,3389.42,27115.4
2021-01-25,RTGS,31016.3,0.0,58131.7
2021-01-25,Reversal,0.0,6459.08,51672.62
2021-01-25,Purchase,3.6,0.0,51676.22
2021-01-25,Purchase,0.0,25838.11,25838.11
2021-01-25,Bill,2760.05,0.0,28598.16
2021-01-25,Miscellaneous,0.0,3177.57,25420.59
2021-01-25,Cash,0.0,12710.3,12710.3
2021-01-25,Miscellaneous,2933.0,0.0,15643.3
2021-01-26,IMPS,0.0,1564.33,14078.97
2021-01-27,IMPS,6.0,0.0,14084.97
2021-01-27,Cash,231289.1,0.0,245374.07
2021-01-27,IMPS,0.0,245374.07,0.0
2021-01-27,Transfer,127232.0,0.0,127232.0
2021-01-27,Miscellaneous,0.0,42410.67,84821.33
2021-01-27,ATM,0.0,10602.67,74218.66
2021-01-27,Interest,0.0,7421.87,66796.79
2021-01-27,Miscellaneous,5447.5,0.0,72244.29
2021-01-27,ATM,0.0,10320.61,61923.68
2021-01-28,Miscellaneous,0.0,10320.61,51603.07
2021-01-28,Purchase,0.0,5160.31,46442.76
2021-01-28,Bill,25.0,0.0,46467.76
2021-01-28,Reversal,0.0,15489.25,30978.51
2021-01-28,Transfer,0.0,3872.31,27106.2
2021-01-28,NEFT,54.4,0.0,27160.6
2021-01-28,RTGS,0.0,3880.09,23280.51
2021-01-28,RTGS,0.0,2328.05,20952.46
2021-01-28,Debit Card,0.0,5238.12,15714.34
2021-01-28,Tax,0.0,1571.43,14142.91
2021-01-28,Debit Card,63306.2,0.0,77449.11
2021-01-28,Purchase,26467.5,0.0,103916.61
2021-01-28,IMPS,0.0,12989.58,90927.03
2021-01-28,Purchase,0.0,10103.0,80824.03
2021-01-28,ATM,21774.7,0.0,102598.73
2021-01-28,Purchase,0.0,10259.87,92338.86
2021-01-28,Cheque,0.0,30779.62,61559.24
2021-01-28,NEFT,0.0,6155.92,55403.32
2021-01-28,RTGS,0.0,18467.77,36935.55
2021-01-28,Reversal,0.0,18467.78,18467.78
2021-01-28,Miscellaneous,4.0,0.0,18471.78
2021-01-28,Miscellaneous,1506099.5,0.0,1524571.28
2021-01-28,Tax,23057.0,0.0,1547628.28
2021-01-28,Miscellaneous,0.0,257938.05,1289690.23
2021-01-28,Debit Card,178364.09,0.0,1468054.32
2021-01-28,IMPS,0.0,367013.58,1101040.74
2021-01-28,Reversal,0.0,367013.58,734027.16
2021-01-28,ATM,418952.0,0.0,1152979.16
2021-01-28,Reversal,2968.98,0.0,1155948.14
2021-01-28,Miscellaneous,0.0,231189.63,924758.51
2021-01-28,Commission,0.0,154126.42,770632.09
2021-01-28,Tax,0.0,385316.05,385316.04
2021-01-28,Miscellaneous,9.0,0.0,385325.04
2021-01-28,Miscellaneous,0.0,42813.89,342511.15
2021-01-28,Interest,14835.9,0.0,357347.05
2021-01-28,Reversal,2.0,0.0,357349.05
2021-01-28,NEFT,418.0,0.0,357767.05
2021-01-28,IMPS,0.0,178883.53,178883.52
2021-01-28,Bill,699.0,0.0,179582.52
2021-01-28,Interest,0.0,59860.84,119721.68
2021-01-28,Cash,0.0,23944.34,95777.34
2021-01-28,Bill,8991.41,0.0,104768.75
2021-01-28,Commission,0.0,26192.19,78576.56
2021-01-28,Tax,0.0,8730.73,69845.83
2021-01-28,Commission,0.0,34922.92,34922.92
2021-01-28,ATM,235.5,0.0,35158.42
2021-01-28,RTGS,0.0,3906.49,31251.93
2021-01-28,Purchase,5.3,0.0,31257.23
2021-01-28,Tax,0.0,3907.15,27350.08
2021-01-28,Miscellaneous,21730.76,0.0,49080.84
2021-01-28,Cheque,0.0,4908.08,44172.76
2021-01-28,Bill,0.0,44172.76,0.0
2021-01-28,Debit Card,3.78,0.0,3.78
2021-01-28,Commission,0.0,0.0,3.78
2021-01-28,Reversal,1.0,0.0,4.78
2021-01-28,Tax,105139.0,0.0,105143.78
2021-01-28,Cheque,0.0,26285.95,78857.83
2021-01-28,Miscellaneous,0.0,15771.57,63086.26
2021-01-29,Bill,0.0,15771.57,47314.7
2021-01-29,Reversal,200.34,0.0,47515.04
2021-01-29,IMPS,0.0,6787.86,40727.18
2021-01-29,Tax,0.0,4525.24,36201.94
2021-01-29,Tax,0.0,4525.24,31676.7
2021-01-29,Miscellaneous,0.0,3959.59,27717.11
2021-01-29,IMPS,0.0,3464.64,24252.47
2021-01-29,Tax,30908.0,0.0,55160.47
2021-01-29,Miscellaneous,0.0,5516.05,49644.42
2021-01-29,Miscellaneous,5.59,0.0,49650.01
2021-01-29,Bill,24.53,0.0,49674.54
2021-01-29,Bill,5280.87,0.0,54955.41
2021-01-29,Transfer,0.0,6869.43,48085.98
2021-01-29,Purchase,2.0,0.0,48087.98
2021-01-29,NEFT,0.0,5343.11,42744.87
2021-01-29,Bill,41.27,0.0,42786.14
2021-01-29,Commission,0.0,10696.54,32089.6
2021-01-29,Bill,0.0,16044.8,16044.8
2021-01-29,RTGS,7.0,0.0,16051.8
2021-01-29,Tax,28.0,0.0,16079.8
2021-01-29,Cheque,83420.0,0.0,99499.8
2021-01-29,Interest,0.0,11055.53,88444.27
2021-01-29,Transfer,0.0,12634.9,75809.37
2021-01-29,Cash,0.0,75809.37,0.0
2021-01-29,Cheque,262.24,0.0,262.24
2021-01-29,Commission,0.0,87.41,174.83
2021-01-29,Interest,0.0,0.0,174.83
2021-01-29,Debit Card,205.4,0.0,380.23
2021-01-29,Bill,0.0,380.23,0.0
2021-01-29,ATM,22.0,0.0,22.0
2021-01-29,Transfer,150082.1,0.0,150104.1
2021-01-29,Miscellaneous,52.8,0.0,150156.9
2021-01-30,Miscellaneous,0.0,30031.38,120125.52
2021-01-30,Interest,0.0,20020.92,100104.6
2021-01-30,IMPS,0.0,25026.15,75078.45
2021-01-30,Bill,0.0,75078.45,0.0
2021-01-30,NEFT,315.0,0.0,315.0
2021-01-30,Interest,41620.0,0.0,41935.0
2021-01-30,Commission,0.0,20967.5,20967.5
2021-01-30,RTGS,14393.0,0.0,35360.5
2021-01-30,Miscellaneous,22889.0,0.0,58249.5
2021-01-30,Miscellaneous,0.0,58249.5,0.0
2021-01-30,Bill,309.0,0.0,309.0
2021-01-30,Commission,0.0,51.5,257.5
2021-01-30,NEFT,54.0,0.0,311.5
2021-01-30,Purchase,27129.0,0.0,27440.5
2021-01-30,Cash,5048.0,0.0,32488.5
2021-01-30,IMPS,50.79,0.0,32539.29
2021-01-30,Interest,50.0,0.0,32589.29
2021-01-30,Cheque,0.0,3621.03,28968.26
2021-01-30,Transfer,0.0,4138.32,24829.94
2021-01-30,Interest,2167.6,0.0,26997.54
2021-01-30,Commission,3088.2,0.0,30085.74
2021-01-30,Reversal,0.0,15042.87,15042.87
2021-01-30,Reversal,190204.3,0.0,205247.17
2021-01-30,ATM,0.0,20524.72,184722.45
2021-01-30,NEFT,0.0,26388.92,158333.53
2021-01-30,ATM,197.57,0.0,158531.1
2021-01-30,Cash,6.4,0.0,158537.5
2021-01-30,Commission,152551.4,0.0,311088.9
2021-01-30,Bill,0.0,311088.9,0.0
2021-01-30,IMPS,4181.1,0.0,4181.1
2021-01-30,Bill,0.0,2090.55,2090.55
2021-01-30,Cheque,0.0,522.64,1567.91
2021-01-30,Tax,0.0,391.98,1175.93
2021-01-30,Purchase,98274.0,0.0,99449.93
2021-01-30,Tax,0.0,19889.99,79559.94
2021-01-30,Purchase,6.0,0.0,79565.94
2021-01-30,IMPS,27105.0,0.0,106670.94
2021-01-30,Reversal,0.0,106670.94,0.0
2021-01-30,ATM,13405.8,0.0,13405.8
2021-01-30,Cheque,38.5,0.0,13444.3
2021-01-30,Purchase,0.0,3361.08,10083.22
2021-01-30,Purchase,5.6,0.0,10088.82
2021-01-30,Debit Card,396.7,0.0,10485.52
2021-01-30,Bill,0.0,3495.17,6990.35
2021-01-30,Debit Card,1.6,0.0,6991.95
2021-01-30,RTGS,37.0,0.0,7028.95
2021-01-30,Tax,104.26,0.0,7133.21
2021-01-30,Bill,241.0,0.0,7374.21
2021-01-30,RTGS,0.0,1843.55,5530.66
2021-01-30,Reversal,0.0,921.78,4608.88
2021-01-30,NEFT,0.0,1536.29,3072.59
2021-01-30,ATM,0.0,614.52,2458.07
2021-01-30,Cash,0.0,245.81,2212.26
2021-01-30,Bill,0.0,553.07,1659.2
2021-01-30,Transfer,0.0,237.03,1422.17
2021-01-30,NEFT,0.0,711.09,711.08
2021-01-30,Cash,2276.0,0.0,2987.08
2021-01-30,Tax,0.0,746.77,2240.31
2021-01-30,Miscellaneous,155993.7,0.0,158234.01
2021-01-30,Purchase,2.58,0.0,158236.59
2021-01-30,Bill,1674.8,0.0,159911.39
2021-01-30,Commission,137763.62,0.0,297675.01
2021-01-30,Tax,0.0,33075.0,264600.01
2021-01-30,Debit Card,1817358.0,0.0,2081958.01
2021-01-30,Purchase,6.07,0.0,2081964.08
2021-01-30,Transfer,341.5,0.0,2082305.58
2021-01-30,Transfer,2975.0,0.0,2085280.58
2021-01-30,ATM,0.0,297897.23,1787383.35
2021-01-30,Bill,0.0,893691.68,893691.68
2021-01-30,Miscellaneous,677971.0,0.0,1571662.68
2021-01-30,NEFT,2.08,0.0,1571664.76
2021-01-30,NEFT,0.0,392916.19,1178748.57
2021-01-30,Cash,3179.7,0.0,1181928.27
2021-01-30,RTGS,0.0,196988.05,984940.22
2021-01-30,Reversal,0.0,109437.8,875502.42
2021-01-30,Miscellaneous,0.0,109437.8,766064.62
2021-01-30,RTGS,516991.25,0.0,1283055.87
2021-01-30,Debit Card,1275.0,0.0,1284330.87
2021-01-30,Interest,0.0,160541.36,1123789.51
2021-01-30,Cheque,0.0,224757.9,899031.61
2021-01-30,Tax,0.0,112378.95,786652.66
2021-01-30,Interest,0.0,786652.66,0.0
2021-01-30,Miscellaneous,112027.97,0.0,112027.97
2021-01-30,Interest,0.0,112027.97,0.0
2021-01-30,Purchase,5.0,0.0,5.0
2021-01-30,Interest,18.0,0.0,23.0
2021-01-30,Debit Card,170.0,0.0,193.0
2021-01-30,IMPS,0.0,96.5,96.5
2021-01-30,ATM,306.0,0.0,402.5
2021-01-30,Reversal,194521.0,0.0,194923.5
2021-01-30,Cheque,305125.75,0.0,500049.25
2021-01-30,Cheque,0.0,125012.31,375036.94
2021-01-30,Cash,184777.0,0.0,559813.94
2021-01-31,Cash,9171.83,0.0,568985.77
2021-01-31,Miscellaneous,104971.1,0.0,673956.87
2021-02-01,Commission,7.9,0.0,673964.77
2021-02-01,IMPS,0.0,134792.95,539171.82
2021-02-01,Miscellaneous,10.0,0.0,539181.82
2021-02-01,ATM,0.0,53918.18,485263.64
2021-02-01,IMPS,0.0,80877.27,404386.37
2021-02-01,Reversal,0.0,101096.59,303289.78
2021-02-01,Reversal,2443.08,0.0,305732.86
2021-02-01,Interest,0.0,50955.48,254777.38
2021-02-02,Commission,1836.0,0.0,256613.38
2021-02-02,Cash,0.0,36659.05,219954.33
2021-02-02,Bill,0.0,73318.11,146636.22
2021-02-02,Bill,0.0,146636.22,0.0
2021-02-02,IMPS,8.0,0.0,8.0
2021-02-02,Transfer,0.0,1.33,6.67
2021-02-02,NEFT,0.0,0.83,5.84
2021-02-02,Cash,30.3,0.0,36.14
2021-02-02,Bill,3.0,0.0,39.14
2021-02-02,Debit Card,0.0,4.35,34.79
2021-02-02,Cash,7040.69,0.0,7075.48
2021-02-02,Commission,0.0,707.55,6367.93
2021-02-02,ATM,0.0,6367.93,0.0
2021-02-02,Cheque,31.8,0.0,31.8
2021-02-02,Cheque,0.0,4.54,27.26
2021-02-02,Cheque,0.0,6.82,20.44
2021-02-03,Transfer,0.0,2.04,18.4
2021-02-03,RTGS,61.0,0.0,79.4
2021-02-03,Purchase,1799.0,0.0,1878.4
2021-02-03,Bill,1.61,0.0,1880.01
2021-02-04,Debit Card,0.0,376.0,1504.01
2021-02-04,Commission,0.0,188.0,1316.01
2021-02-04,Commission,4611.2,0.0,5927.21
2021-02-04,ATM,0.0,987.87,4939.34
2021-02-04,Reversal,0.0,823.22,4116.12
2021-02-04,Tax,0.0,2058.06,2058.06
2021-02-04,Cheque,38.5,0.0,2096.56
2021-02-04,Miscellaneous,0.0,232.95,1863.61
2021-02-04,Tax,0.0,621.2,1242.41
2021-02-04,Reversal,0.0,621.21,621.21
2021-02-04,NEFT,0.0,88.74,532.47
2021-02-04,IMPS,2204.0,0.0,2736.47
2021-02-04,IMPS,0.0,390.92,2345.55
2021-02-04,Debit Card,0.0,335.08,2010.47
2021-02-04,Purchase,2542.0,0.0,4552.47
2021-02-04,Cheque,0.0,2276.24,2276.24
2021-02-04,Tax,0.0,325.18,1951.06
2021-02-04,Cash,0.0,325.18,1625.88
2021-02-04,Tax,0.0,203.24,1422.64
2021-02-04,Cash,50895.59,0.0,52318.23
2021-02-04,Miscellaneous,0.0,26159.12,26159.12
2021-02-04,Bill,10525.79,0.0,36684.91
2021-02-04,Tax,173984.5,0.0,210669.41
2021-02-04,Bill,0.0,42133.88,168535.53
2021-02-04,ATM,0.0,84267.77,84267.76
2021-02-04,Interest,102106.66,0.0,186374.42
2021-02-04,NEFT,426.97,0.0,186801.39
2021-02-04,Purchase,152840.0,0.0,339641.39
2021-02-04,ATM,0.0,113213.8,226427.59
2021-02-04,Miscellaneous,0.0,22642.76,203784.83
2021-02-04,RTGS,4882.0,0.0,208666.83
2021-02-04,ATM,261.6,0.0,208928.43
2021-02-04,RTGS,26.0,0.0,208954.43
2021-02-04,Cash,2.73,0.0,208957.16
2021-02-04,Commission,0.0,23217.46,185739.7
2021-02-04,Debit Card,60552.75,0.0,246292.45
2021-02-04,Cheque,0.0,82097.48,164194.97
2021-02-05,RTGS,0.0,27365.83,136829.14
2021-02-05,Debit Card,195150.0,0.0,331979.14
2021-02-05,Miscellaneous,126.7,0.0,332105.84
2021-02-05,Transfer,1861.6,0.0,333967.44
2021-02-05,NEFT,663201.0,0.0,997168.44
2021-02-05,Transfer,71995.0,0.0,1069163.44
2021-02-05,Commission,0.8,0.0,1069164.24
2021-02-05,Commission,21567.7,0.0,1090731.94
2021-02-05,Purchase,2879.6,0.0,1093611.54
2021-02-05,Debit Card,0.0,273402.89,820208.66
2021-02-05,Cheque,0.0,91134.3,729074.36
2021-02-05,Interest,137224.94,0.0,866299.3
2021-02-05,RTGS,465479.2,0.0,1331778.5
2021-02-05,Transfer,0.0,147975.39,1183803.11
2021-02-05,RTGS,0.0,169114.73,1014688.38
2021-02-05,Interest,0.0,202937.68,811750.7
2021-02-05,Commission,0.0,81175.07,730575.63
2021-02-05,ATM,768.9,0.0,731344.53
2021-02-05,Cheque,0.0,81260.5,650084.03
2021-02-05,Purchase,1.0,0.0,650085.03
2021-02-05,ATM,88.21,0.0,650173.24
2021-02-05,Debit Card,0.0,108362.21,541811.03
2021-02-05,NEFT,22945.42,0.0,564756.45
2021-02-05,Purchase,6.0,0.0,564762.45
2021-02-05,Cash,0.0,282381.23,282381.22
2021-02-05,Cash,162922.2,0.0,445303.42
2021-02-05,Interest,7.0,0.0,445310.42
2021-02-05,Reversal,56.3,0.0,445366.72
2021-02-05,Cheque,0.0,148455.57,296911.15
2021-02-05,Debit Card,5953.95,0.0,302865.1
2021-02-05,Purchase,4.93,0.0,302870.03
2021-02-05,Debit Card,206989.8,0.0,509859.83
2021-02-05,IMPS,4.36,0.0,509864.19
2021-02-05,Commission,3.0,0.0,509867.19
2021-02-06,Transfer,51.58,0.0,509918.77
2021-02-06,Debit Card,0.0,56657.64,453261.13
2021-02-06,Transfer,0.0,75543.52,377717.61
2021-02-06,Tax,0.0,188858.81,188858.8
2021-02-06,Miscellaneous,7.7,0.0,188866.5
2021-02-07,Commission,2.2,0.0,188868.7
2021-02-07,Debit Card,27.4,0.0,188896.1
2021-02-07,Cheque,16.2,0.0,188912.3
2021-02-07,NEFT,254231.0,0.0,443143.3
2021-02-08,Debit Card,656799.5,0.0,1099942.8
2021-02-08,Miscellaneous,0.0,549971.4,549971.4
2021-02-08,Transfer,0.0,549971.4,0.0
2021-02-08,Cash,1165996.75,0.0,1165996.75
2021-02-08,Commission,0.0,1165996.75,0.0
2021-02-08,Purchase,15202.5,0.0,15202.5
2021-02-08,Commission,17594.8,0.0,32797.3
2021-02-08,Miscellaneous,0.0,4099.66,28697.64
2021-02-08,Cheque,0.0,4099.66,24597.98
2021-02-08,NEFT,1.1,0.0,24599.08
2021-02-08,Cash,38.5,0.0,24637.58
2021-02-08,Transfer,0.0,4927.52,19710.06
2021-02-08,Reversal,83.71,0.0,19793.77
2021-02-08,RTGS,277.0,0.0,20070.77
2021-02-08,Cheque,159045.2,0.0,179115.97
2021-02-08,Commission,0.0,19901.77,159214.2
2021-02-08,Transfer,0.0,22744.89,136469.31
2021-02-08,Purchase,0.0,136469.31,0.0
2021-02-08,Purchase,6.89,0.0,6.89
2021-02-08,Debit Card,0.0,6.89,0.0
2021-02-08,Reversal,117.0,0.0,117.0
2021-02-09,Debit Card,0.0,14.63,102.38
2021-02-09,Transfer,0.0,51.19,51.19
2021-02-09,Miscellaneous,1256.9,0.0,1308.09
2021-02-09,Tax,9767.5,0.0,11075.59
2021-02-09,Bill,1565137.25,0.0,1576212.84
2021-02-09,ATM,0.0,788106.42,788106.42
2021-02-09,RTGS,3481.7,0.0,791588.12
2021-02-09,Cheque,7586.0,0.0,799174.12
2021-02-09,Reversal,0.0,114167.73,685006.39
2021-02-09,Debit Card,0.0,685006.39,0.0
2021-02-09,RTGS,13.0,0.0,13.0
2021-02-09,Commission,403.0,0.0,416.0
2021-02-09,Purchase,0.0,208.0,208.0
2021-02-09,Purchase,60.0,0.0,268.0
2021-02-09,Miscellaneous,5.6,0.0,273.6
2021-02-09,Reversal,0.0,39.09,234.51
2021-02-09,Purchase,0.0,33.5,201.01
2021-02-09,ATM,120945.5,0.0,121146.51
2021-02-09,Transfer,0.0,121146.51,0.0
2021-02-09,Cash,20202.2,0.0,20202.2
2021-02-09,Tax,4.03,0.0,20206.23
2021-02-09,Reversal,217975.0,0.0,238181.23
2021-02-09,Purchase,2736.27,0.0,240917.5
2021-02-09,Reversal,0.0,60229.38,180688.12
2021-02-09,Transfer,1538208.0,0.0,1718896.12
2021-02-09,ATM,437.56,0.0,1719333.68
2021-02-09,NEFT,0.0,343866.74,1375466.94
2021-02-09,Interest,0.0,229244.49,1146222.45
2021-02-09,Purchase,786499.25,0.0,1932721.7
2021-02-09,Commission,169989.6,0.0,2102711.3
2021-02-10,Interest,5.5,0.0,2102716.8
2021-02-10,Transfer,0.0,300388.11,1802328.69
2021-02-10,Purchase,0.0,1802328.69,0.0
2021-02-10,IMPS,1832184.0,0.0,1832184.0
2021-02-10,IMPS,0.0,305364.0,1526820.0
2021-02-10,RTGS,1907.0,0.0,1528727.0
2021-02-10,Transfer,16638.0,0.0,1545365.0
2021-02-10,ATM,0.0,171707.22,1373657.78
2021-02-10,ATM,0.0,228942.96,1144714.82
2021-02-10,RTGS,18.0,0.0,1144732.82
2021-02-10,RTGS,0.0,0.0,1144732.82
2021-02-10,Cheque,114413.75,0.0,1259146.57
2021-02-10,Cash,10059.65,0.0,1269206.22
2021-02-10,IMPS,5.57,0.0,1269211.79
2021-02-10,Debit Card,7.0,0.0,1269218.79
2021-02-10,NEFT,20.2,0.0,1269238.99
2021-02-10,Interest,52.0,0.0,1269290.99
2021-02-10,Tax,0.0,1269290.99,0.0
2021-02-10,Purchase,1.5,0.0,1.5
2021-02-10,ATM,1491044.0,0.0,1491045.5
2021-02-10,Transfer,11166.0,0.0,1502211.5
2021-02-10,IMPS,0.0,214601.64,1287609.86
2021-02-10,ATM,0.0,143067.76,1144542.1
2021-02-10,ATM,49.6,0.0,1144591.7
2021-02-10,Purchase,39075.0,0.0,1183666.7
2021-02-10,IMPS,0.0,118366.67,1065300.03
2021-02-10,Interest,0.0,177550.01,887750.02
2021-02-10,Bill,7.4,0.0,887757.42
2021-02-10,Reversal,0.0,221939.36,665818.07
2021-02-10,Commission,0.0,332909.04,332909.03
2021-02-10,Commission,0.0,36989.89,295919.14
2021-02-10,Tax,9552.0,0.0,305471.14
2021-02-11,Transfer,0.0,61094.23,244376.91
2021-02-12,NEFT,0.0,48875.38,195501.53
2021-02-12,NEFT,3324.0,0.0,198825.53
2021-02-12,Bill,20.3,0.0,198845.83
2021-02-12,Cheque,0.0,99422.92,99422.92
2021-02-12,NEFT,272529.5,0.0,371952.42
2021-02-12,Reversal,20756.0,0.0,392708.42
2021-02-12,Purchase,10.13,0.0,392718.55
2021-02-12,Interest,0.0,49089.82,343628.73
2021-02-13,Tax,0.0,171814.37,171814.36
2021-02-13,Purchase,735620.0,0.0,907434.36
2021-02-13,Tax,0.0,302478.12,604956.24
2021-02-13,Commission,11904.22,0.0,616860.46
2021-02-14,Purchase,25878.62,0.0,642739.08
2021-02-14,IMPS,2.0,0.0,642741.08
2021-02-14,Miscellaneous,0.0,64274.11,578466.97
2021-02-14,Tax,5.0,0.0,578471.97
2021-02-14,Cheque,0.0,57847.2,520624.77
2021-02-14,NEFT,0.0,57847.2,462777.57
2021-02-14,RTGS,0.0,462777.57,0.0
2021-02-14,Tax,3.83,0.0,3.83
2021-02-15,Bill,0.0,0.55,3.28
2021-02-15,Purchase,0.0,0.33,2.95
2021-02-15,Debit Card,0.0,0.74,2.21
2021-02-15,Reversal,2.24,0.0,4.45
2021-02-16,Transfer,206351.0,0.0,206355.45
2021-02-16,RTGS,0.0,29479.35,176876.1
2021-02-16,Cheque,0.0,88438.05,88438.05
2021-02-16,IMPS,0.0,44219.03,44219.02
2021-02-16,Reversal,0.0,11054.76,33164.26
2021-02-16,Debit Card,483187.25,0.0,516351.51
2021-02-16,Reversal,0.0,86058.59,430292.92
2021-02-16,Interest,0.0,43029.29,387263.63
2021-02-16,Cash,0.0,193631.82,193631.82
2021-02-16,ATM,0.0,27661.69,165970.13
2021-02-16,Bill,442024.0,0.0,607994.13
2021-02-16,Reversal,31580.0,0.0,639574.13
2021-02-16,Interest,169.96,0.0,639744.09
2021-02-16,Miscellaneous,0.0,71082.68,568661.41
2021-02-16,Reversal,193762.4,0.0,762423.81
2021-02-16,Transfer,15.2,0.0,762439.01
2021-02-16,RTGS,331.6,0.0,762770.61
2021-02-16,Transfer,855068.0,0.0,1617838.61
2021-02-16,Bill,1.0,0.0,1617839.61
2021-02-16,RTGS,670.55,0.0,1618510.16
2021-02-16,Debit Card,6.5,0.0,1618516.66
2021-02-16,Miscellaneous,0.0,179835.18,1438681.48
2021-02-16,IMPS,0.0,239780.25,1198901.23
2021-02-16,Cash,0.0,119890.12,1079011.11
2021-02-16,Tax,45.0,0.0,1079056.11
2021-02-16,Purchase,0.0,215811.22,863244.89
2021-02-16,Commission,0.0,431622.45,431622.44
2021-02-16,Interest,0.0,215811.22,215811.22
2021-02-16,Transfer,0.0,107905.61,107905.61
2021-02-16,Purchase,267.0,0.0,108172.61
2021-02-16,Purchase,0.0,15453.23,92719.38
2021-02-16,ATM,6659.3,0.0,99378.68
2021-02-16,Bill,5.0,0.0,99383.68
2021-02-16,Commission,415.3,0.0,99798.98
2021-02-16,ATM,1414538.0,0.0,1514336.98
2021-02-16,Cash,2968.3,0.0,1517305.28
2021-02-16,Interest,30035.0,0.0,1547340.28
2021-02-16,NEFT,19.0,0.0,1547359.28
2021-02-16,Debit Card,0.0,773679.64,773679.64
2021-02-16,Tax,144.1,0.0,773823.74
2021-02-16,ATM,2122.1,0.0,775945.84
2021-02-16,Transfer,0.0,155189.17,620756.67
2021-02-16,Transfer,638848.0,0.0,1259604.67
2021-02-16,RTGS,24057.0,0.0,1283661.67
2021-02-16,Interest,0.0,128366.17,1155295.5
2021-02-16,Miscellaneous,501.0,0.0,1155796.5
2021-02-16,Transfer,186.0,0.0,1155982.5
2021-02-16,Bill,3161.94,0.0,1159144.44
2021-02-16,Bill,239.6,0.0,1159384.04
2021-02-16,RTGS,59.05,0.0,1159443.09
2021-02-16,Tax,2084854.0,0.0,3244297.09
2021-02-16,Debit Card,1687.1,0.0,3245984.19
2021-02-16,Miscellaneous,0.0,540997.37,2704986.82
2021-02-16,Interest,18687.4,0.0,2723674.22
2021-02-16,ATM,1715361.0,0.0,4439035.22
2021-02-16,Interest,0.0,887807.04,3551228.18
2021-02-16,NEFT,0.0,1183742.73,2367485.45
2021-02-16,Cheque,0.0,295935.68,2071549.77
2021-02-16,Miscellaneous,0.0,207154.98,1864394.79
2021-02-16,Transfer,13.3,0.0,1864408.09
2021-02-16,NEFT,0.0,932204.05,932204.04
2021-02-16,Commission,173.1,0.0,932377.14
2021-02-16,Cheque,1237.4,0.0,933614.54
2021-02-16,NEFT,275.0,0.0,933889.54
2021-02-16,Reversal,0.0,466944.77,466944.77
2021-02-16,Bill,0.0,51882.75,415062.02
2021-02-16,Reversal,0.0,83012.4,332049.62
2021-02-16,Commission,0.0,36894.4,295155.22
2021-02-16,Debit Card,32.17,0.0,295187.39
2021-02-16,Reversal,0.0,36898.42,258288.97
2021-02-16,NEFT,0.0,28698.77,229590.2
2021-02-16,Bill,0.0,76530.07,153060.13
2021-02-16,IMPS,0.0,51020.04,102040.09
2021-02-16,Cash,1400.45,0.0,103440.54
2021-02-16,Bill,0.0,25860.14,77580.4
2021-02-16,Bill,0.0,38790.2,38790.2
2021-02-16,Miscellaneous,2481.3,0.0,41271.5
2021-02-16,Interest,0.0,5895.93,35375.57
2021-02-16,Tax,25643.0,0.0,61018.57
2021-02-16,IMPS,24318.8,0.0,85337.37
2021-02-16,Commission,0.0,21334.34,64003.03
2021-02-16,Commission,330.58,0.0,64333.61
2021-02-16,Bill,29.15,0.0,64362.76
2021-02-16,Purchase,17693.15,0.0,82055.91
2021-02-16,Bill,22198.74,0.0,104254.65
2021-02-16,Cash,244.0,0.0,104498.65
2021-02-16,NEFT,0.0,14928.38,89570.27
2021-02-16,Cash,285.0,0.0,89855.27
2021-02-16,Tax,0.0,29951.76,59903.51
2021-02-16,Bill,0.0,14975.88,44927.63
2021-02-16,Tax,492.0,0.0,45419.63
2021-02-16,ATM,152.24,0.0,45571.87
2021-02-16,Debit Card,51944.69,0.0,97516.56
2021-02-16,NEFT,4750.0,0.0,102266.56
2021-02-16,Purchase,312495.0,0.0,414761.56
2021-02-16,Reversal,0.26,0.0,414761.82
2021-02-16,Tax,0.0,207380.91,207380.91
2021-02-16,Tax,14566.38,0.0,221947.29
2021-02-16,Interest,596794.0,0.0,818741.29
2021-02-16,Cash,0.0,409370.65,409370.64
2021-02-16,Commission,1883996.0,0.0,2293366.64
2021-02-16,Commission,0.0,458673.33,1834693.31
2021-02-16,Transfer,219.21,0.0,1834912.52
2021-02-16,ATM,15989.14,0.0,1850901.66
2021-02-16,Tax,0.0,925450.83,925450.83
2021-02-16,ATM,2019710.2,0.0,2945161.03
2021-02-16,Cheque,24358.0,0.0,2969519.03
2021-02-16,Transfer,214107.75,0.0,3183626.78
2021-02-16,Debit Card,388.37,0.0,3184015.15
2021-02-16,Transfer,0.0,398001.89,2786013.26
2021-02-16,Bill,381.5,0.0,2786394.76
2021-02-16,Transfer,0.0,278639.48,2507755.28
2021-02-16,Commission,0.0,1253877.64,1253877.64
2021-02-16,Tax,20.91,0.0,1253898.55
2021-02-16,Debit Card,0.0,313474.64,940423.91
2021-02-16,Cash,0.0,313474.64,626949.27
2021-02-16,Transfer,0.0,626949.27,0.0
2021-02-16,Interest,3292.1,0.0,3292.1
2021-02-16,IMPS,0.0,470.3,2821.8
2021-02-16,Debit Card,0.0,940.6,1881.2
2021-02-16,Bill,0.0,209.02,1672.18
2021-02-16,Reversal,0.0,836.09,836.09
2021-02-17,Tax,0.0,836.09,0.0
2021-02-17,Cheque,13.1,0.0,13.1
2021-02-17,IMPS,4282.0,0.0,4295.1
2021-02-17,Purchase,0.0,613.59,3681.51
2021-02-17,Bill,3747.3,0.0,7428.81
2021-02-17,Commission,0.0,1485.76,5943.05
2021-02-17,Bill,0.0,1485.76,4457.29
2021-02-17,Bill,24.7,0.0,4481.99
2021-02-17,Tax,225090.25,0.0,229572.24
2021-02-17,Commission,136957.7,0.0,366529.94
2021-02-17,Purchase,437.04,0.0,366966.98
2021-02-17,Commission,3.98,0.0,366970.96
2021-02-17,Cheque,19773.0,0.0,386743.96
2021-02-17,NEFT,226540.0,0.0,613283.96
2021-02-17,Commission,0.0,61328.4,551955.56
2021-02-17,Debit Card,219670.2,0.0,771625.76
2021-02-17,NEFT,0.0,257208.59,514417.17
2021-02-17,Purchase,0.0,257208.59,257208.58
2021-02-17,Cheque,0.0,128604.29,128604.29
2021-02-17,Cash,0.0,12860.43,115743.86
2021-02-17,Purchase,0.9,0.0,115744.76
2021-02-17,IMPS,3041.0,0.0,118785.76
2021-02-17,Cash,0.0,23757.15,95028.61
2021-02-17,Reversal,0.0,11878.58,83150.03
2021-02-17,Cheque,19.0,0.0,83169.03
2021-02-17,Purchase,0.0,16633.81,66535.22
2021-02-17,Commission,0.0,22178.41,44356.81
2021-02-17,Purchase,0.0,8871.36,35485.45
2021-02-17,Cheque,41.78,0.0,35527.23
2021-02-17,Interest,0.0,3552.72,31974.51
2021-02-17,Interest,19637.41,0.0,51611.92
2021-02-17,Bill,0.0,5734.66,45877.26
2021-02-17,Commission,154.73,0.0,46031.99
2021-02-17,Cash,22280.0,0.0,68311.99
2021-02-18,Tax,2806.98,0.0,71118.97
2021-02-18,IMPS,46.49,0.0,71165.46
2021-02-18,Debit Card,179.0,0.0,71344.46
2021-02-18,Tax,0.0,11890.74,59453.72
2021-02-18,Purchase,30.49,0.0,59484.21
2021-02-18,ATM,3.3,0.0,59487.51
2021-02-18,IMPS,484.06,0.0,59971.57
2021-02-18,Commission,0.0,8567.37,51404.2
2021-02-18,Cheque,0.0,25702.1,25702.1
2021-02-18,Purchase,2.7,0.0,25704.8
2021-02-18,ATM,69.0,0.0,25773.8
2021-02-18,Purchase,0.0,25773.8,0.0
2021-02-18,Tax,966022.0,0.0,966022.0
2021-02-18,Miscellaneous,0.0,161003.67,805018.33
2021-02-18,Miscellaneous,0.0,115002.62,690015.71
2021-02-18,Commission,0.0,230005.24,460010.47
2021-02-18,Purchase,2274.0,0.0,462284.47
2021-02-18,Reversal,0.3,0.0,462284.77
2021-02-19,NEFT,0.0,115571.19,346713.58
2021-02-19,Transfer,0.0,115571.19,231142.39
2021-02-19,IMPS,5165.0,0.0,236307.39
2021-02-19,ATM,1179924.0,0.0,1416231.39
2021-02-19,Debit Card,84.7,0.0,1416316.09
2021-02-19,Tax,2881.0,0.0,1419197.09
2021-02-19,Interest,0.0,473065.7,946131.39
2021-02-19,RTGS,0.0,105125.71,841005.68
2021-02-19,IMPS,0.0,210251.42,630754.26
2021-02-20,Reversal,56.26,0.0,630810.52
2021-02-20,Miscellaneous,110838.31,0.0,741648.83
2021-02-20,Tax,48191.0,0.0,789839.83
2021-02-20,Tax,1182284.0,0.0,1972123.83
2021-02-20,Reversal,30.23,0.0,1972154.06
2021-02-20,Reversal,0.0,281736.29,1690417.77
2021-02-20,Purchase,0.0,1690417.77,0.0
2021-02-20,Commission,426551.0,0.0,426551.0
2021-02-20,IMPS,0.0,42655.1,383895.9
2021-02-20,Debit Card,185.0,0.0,384080.9
2021-02-20,IMPS,0.0,128026.97,256053.93
2021-02-20,RTGS,0.0,85351.31,170702.62
2021-02-20,ATM,2.0,0.0,170704.62
2021-02-20,Debit Card,0.0,34140.92,136563.7
2021-02-20,Commission,0.0,136563.7,0.0
2021-02-21,ATM,3167.0,0.0,3167.0
2021-02-21,Commission,7.3,0.0,3174.3
2021-02-21,Reversal,1350.0,0.0,4524.3
2021-02-21,IMPS,0.0,452.43,4071.87
2021-02-21,Interest,2.0,0.0,4073.87
2021-02-21,Tax,0.0,407.39,3666.48
2021-02-22,Debit Card,0.0,523.78,3142.7
2021-02-22,Cheque,23344.64,0.0,26487.34
2021-02-22,Purchase,0.0,6621.84,19865.5
2021-02-22,Reversal,0.0,6621.83,13243.67
2021-02-22,IMPS,1954740.5,0.0,1967984.17
2021-02-22,NEFT,316.23,0.0,1968300.4
2021-02-22,Cheque,5.4,0.0,1968305.8
2021-02-22,Purchase,0.0,218700.64,1749605.16
2021-02-22,Tax,0.0,249943.59,1499661.57
2021-02-23,NEFT,17.0,0.0,1499678.57
2021-02-23,Interest,1293273.0,0.0,2792951.57
2021-02-23,Cash,400.98,0.0,2793352.55
2021-02-23,Reversal,0.0,2793352.55,0.0
2021-02-23,Tax,3719.0,0.0,3719.0
2021-02-23,Debit Card,3.32,0.0,3722.32
2021-02-23,NEFT,87046.0,0.0,90768.32
2021-02-23,Tax,21650.6,0.0,112418.92
2021-02-23,Reversal,2.0,0.0,112420.92
2021-02-23,IMPS,0.0,37473.64,74947.28
2021-02-23,Purchase,2556.7,0.0,77503.98
2021-02-23,ATM,365.0,0.0,77868.98
2021-02-23,Bill,0.0,9733.62,68135.36
2021-02-23,Reversal,5.0,0.0,68140.36
2021-02-23,Tax,3741.0,0.0,71881.36
2021-02-23,Purchase,0.0,11980.23,59901.13
2021-02-23,Cash,0.0,5990.11,53911.02
2021-02-23,Commission,0.0,17970.34,35940.68
2021-02-23,Interest,0.0,35940.68,0.0
2021-02-23,ATM,180.1,0.0,180.1
2021-02-23,ATM,9.8,0.0,189.9
2021-02-23,Purchase,2354.2,0.0,2544.1
2021-02-23,Commission,4802.9,0.0,7347.0
2021-02-23,Commission,89194.2,0.0,96541.2
2021-02-23,Tax,48.1,0.0,96589.3
2021-02-23,Cheque,0.0,96589.3,0.0
2021-02-23,Bill,3026.2,0.0,3026.2
2021-02-23,Debit Card,0.0,504.37,2521.83
2021-02-23,Miscellaneous,0.0,360.26,2161.57
2021-02-23,Bill,0.0,360.26,1801.31
2021-02-23,Reversal,164760.2,0.0,166561.51
2021-02-23,ATM,0.0,83280.76,83280.76
2021-02-23,Commission,0.0,10410.1,72870.66
2021-02-23,ATM,5.0,0.0,72875.66
2021-02-23,Miscellaneous,210.4,0.0,73086.06
2021-02-23,IMPS,0.0,36543.03,36543.03
2021-02-23,RTGS,0.0,4567.88,31975.15
2021-02-23,Reversal,0.0,7993.79,23981.36
2021-02-23,IMPS,0.0,23981.36,0.0
2021-02-24,Commission,297.7,0.0,297.7
2021-02-24,Transfer,0.0,99.23,198.47
2021-02-24,Purchase,43965.0,0.0,44163.47
2021-02-24,Transfer,11.2,0.0,44174.67
2021-02-24,RTGS,586552.5,0.0,630727.17
2021-02-24,Commission,30.77,0.0,630757.94
2021-02-24,ATM,0.0,78844.74,551913.2
2021-02-24,Cheque,0.0,55191.32,496721.88
2021-02-24,Miscellaneous,0.0,165573.96,331147.92
2021-02-24,Transfer,189318.0,0.0,520465.92
2021-02-24,Interest,12090.45,0.0,532556.37
2021-02-25,Debit Card,0.0,133139.09,399417.28
2021-02-25,RTGS,142.0,0.0,399559.28
2021-02-25,Debit Card,0.0,44395.48,355163.8
2021-02-25,Miscellaneous,0.0,59193.97,295969.83
2021-02-25,Transfer,0.0,49328.31,246641.53
2021-02-25,Debit Card,117.0,0.0,246758.53
2021-02-25,Purchase,1900377.25,0.0,2147135.78
2021-02-25,Bill,0.0,214713.58,1932422.2
2021-02-25,Miscellaneous,0.0,322070.37,1610351.83
2021-02-25,Purchase,0.0,201293.98,1409057.85
2021-02-25,Reversal,737500.25,0.0,2146558.1
2021-02-25,Purchase,20143.5,0.0,2166701.6
2021-02-25,Cash,206011.22,0.0,2372712.82
2021-02-25,Debit Card,0.0,338958.97,2033753.85
2021-02-26,Tax,0.0,225972.65,1807781.2
2021-02-26,NEFT,0.0,301296.87,1506484.33
2021-02-26,Cash,0.0,251080.72,1255403.61
2021-02-26,Transfer,0.0,209233.94,1046169.68
2021-02-26,Interest,0.0,174361.61,871808.07
2021-02-26,Tax,0.0,871808.07,0.0
2021-02-26,Reversal,66507.97,0.0,66507.97
2021-02-26,Cheque,0.0,33253.99,33253.98
2021-02-26,Commission,0.0,4156.75,29097.23
2021-02-26,Debit Card,0.0,3637.15,25460.08
2021-02-27,Purchase,0.0,6365.02,19095.06
2021-02-27,Tax,212978.0,0.0,232073.06
2021-02-27,Interest,88357.0,0.0,320430.06
2021-02-27,Cash,3.36,0.0,320433.42
2021-02-27,Cheque,0.0,45776.2,274657.22
2021-02-27,Debit Card,140.0,0.0,274797.22
2021-02-27,Cash,0.0,91599.07,183198.15
2021-02-27,Interest,0.0,20355.35,162842.8
2021-02-27,Interest,1944.9,0.0,164787.7
2021-02-27,IMPS,1795814.0,0.0,1960601.7
2021-02-27,Miscellaneous,445.82,0.0,1961047.52
2021-02-27,Reversal,8601.0,0.0,1969648.52
2021-02-27,Transfer,0.0,218849.84,1750798.68
2021-02-27,Transfer,238082.0,0.0,1988880.68
2021-02-27,IMPS,0.0,198888.07,1789992.61
2021-02-27,Miscellaneous,60.4,0.0,1790053.01
2021-02-27,Interest,0.0,447513.25,1342539.76
2021-02-27,NEFT,0.0,335634.94,1006904.82
2021-02-27,Miscellaneous,17390.0,0.0,1024294.82
2021-02-27,Bill,0.0,170715.8,853579.02
2021-02-27,Transfer,0.0,853579.02,0.0
2021-02-27,IMPS,3585.55,0.0,3585.55
2021-02-27,Interest,0.0,358.56,3227.0
2021-02-27,Reversal,0.0,461.0,2766.0
2021-02-27,IMPS,0.0,307.33,2458.67
2021-02-27,Interest,0.0,2458.67,0.0
2021-02-27,IMPS,1999962.2,0.0,1999962.2
2021-02-27,IMPS,0.0,399992.44,1599969.76
2021-02-27,Purchase,0.0,177774.42,1422195.34
2021-02-27,ATM,0.3,0.0,1422195.64
2021-02-27,Reversal,0.0,284439.13,1137756.51
2021-02-27,Miscellaneous,0.0,126417.39,1011339.12
2021-02-27,Interest,0.0,1011339.12,0.0
2021-02-27,Bill,127976.0,0.0,127976.0
2021-02-27,Cheque,0.0,127976.0,0.0
2021-02-27,Transfer,3.0,0.0,3.0
2021-02-27,Cash,24569.96,0.0,24572.96
2021-02-27,Miscellaneous,1376.0,0.0,25948.96
2021-02-27,IMPS,7.2,0.0,25956.16
2021-02-27,Bill,0.0,6489.04,19467.12
2021-02-27,IMPS,0.0,9733.56,9733.56
2021-02-28,Bill,53.67,0.0,9787.23
2021-02-28,Cash,0.0,1087.47,8699.76
2021-02-28,Miscellaneous,238051.0,0.0,246750.76
2021-02-28,Purchase,0.0,27416.75,219334.01
2021-02-28,Cheque,0.0,27416.75,191917.26
2021-02-28,Miscellaneous,0.0,31986.21,159931.05
2021-02-28,Commission,0.0,19991.38,139939.67
2021-02-28,Tax,31458.86,0.0,171398.53
2021-02-28,Cheque,8.0,0.0,171406.53
2021-02-28,Commission,58.73,0.0,171465.26
2021-02-28,RTGS,0.82,0.0,171466.08
2021-02-28,IMPS,984.02,0.0,172450.1
2021-02-28,IMPS,4.0,0.0,172454.1
2021-02-28,Interest,0.0,19161.57,153292.53
2021-02-28,Interest,165.0,0.0,153457.53
2021-02-28,Tax,0.0,76728.77,76728.76
2021-02-28,NEFT,0.0,25576.25,51152.51
2021-02-28,Reversal,3112.47,0.0,54264.98
2021-02-28,RTGS,0.0,54264.98,0.0
2021-02-28,Debit Card,116625.97,0.0,116625.97
2021-02-28,Miscellaneous,313.0,0.0,116938.97
2021-02-28,Cheque,446549.0,0.0,563487.97
2021-02-28,Bill,3.2,0.0,563491.17
2021-02-28,Purchase,6.0,0.0,563497.17
2021-02-28,Miscellaneous,203272.0,0.0,766769.17
2021-02-28,Bill,626264.0,0.0,1393033.17
2021-02-28,Reversal,0.0,464344.39,928688.78
2021-02-28,Reversal,71.0,0.0,928759.78
2021-02-28,Transfer,54595.4,0.0,983355.18
2021-02-28,Purchase,811.49,0.0,984166.67
2021-02-28,Cheque,0.0,109351.85,874814.82
2021-02-28,Bill,68033.09,0.0,942847.91
2021-03-01,Transfer,0.0,94284.79,848563.12
2021-03-01,NEFT,343.4,0.0,848906.52
2021-03-01,Miscellaneous,0.0,282968.84,565937.68
2021-03-01,Cash,2.2,0.0,565939.88
2021-03-01,Cheque,0.0,62882.21,503057.67
2021-03-02,Miscellaneous,35.0,0.0,503092.67
2021-03-02,Transfer,0.0,503092.67,0.0
2021-03-02,RTGS,54.0,0.0,54.0
2021-03-02,Tax,1706.7,0.0,1760.7
2021-03-02,ATM,1076.32,0.0,2837.02
2021-03-02,Transfer,0.0,2837.02,0.0
2021-03-02,Cheque,1221.0,0.0,1221.0
2021-03-02,Cheque,0.0,305.25,915.75
2021-03-02,Cash,0.0,305.25,610.5
2021-03-02,RTGS,422673.0,0.0,423283.5
2021-03-02,Debit Card,5176.3,0.0,428459.8
2021-03-02,NEFT,0.0,42845.98,385613.82
2021-03-02,ATM,23318.0,0.0,408931.82
2021-03-02,Transfer,0.0,51116.48,357815.34
2021-03-02,Cash,0.0,39757.26,318058.08
2021-03-02,Transfer,0.0,31805.81,286252.27
2021-03-02,Debit Card,1411565.2,0.0,1697817.47
2021-03-02,Reversal,259399.0,0.0,1957216.47
2021-03-02,Bill,3.9,0.0,1957220.37
2021-03-02,Purchase,45.16,0.0,1957265.53
2021-03-02,Debit Card,7.23,0.0,1957272.76
2021-03-02,Interest,0.0,195727.28,1761545.48
2021-03-02,Debit Card,1114286.0,0.0,2875831.48
2021-03-02,Cheque,167790.4,0.0,3043621.88
2021-03-02,Commission,0.0,1014540.63,2029081.25
2021-03-02,Reversal,0.0,225453.47,1803627.78
2021-03-02,IMPS,3.4,0.0,1803631.18
2021-03-02,IMPS,0.0,1803631.18,0.0
2021-03-02,ATM,62.49,0.0,62.49
2021-03-02,Bill,0.0,62.49,0.0
2021-03-02,IMPS,3710.1,0.0,3710.1
2021-03-02,Reversal,0.0,1236.7,2473.4
2021-03-02,ATM,43.0,0.0,2516.4
2021-03-02,Debit Card,1334579.0,0.0,1337095.4
2021-03-02,Miscellaneous,0.0,222849.23,1114246.17
2021-03-02,Reversal,0.0,222849.23,891396.94
2021-03-02,Miscellaneous,161.7,0.0,891558.64
2021-03-02,Miscellaneous,0.0,445779.32,445779.32
2021-03-02,Debit Card,0.0,148593.11,297186.21
2021-03-02,NEFT,0.0,297186.21,0.0
2021-03-02,Cash,0.4,0.0,0.4
2021-03-02,Transfer,0.0,0.4,0.0
2021-03-02,IMPS,21425.0,0.0,21425.0
2021-03-02,Purchase,257027.31,0.0,278452.31
2021-03-02,Transfer,36.0,0.0,278488.31
2021-03-02,Purchase,0.0,69622.08,208866.23
2021-03-02,Debit Card,29675.0,0.0,238541.23
2021-03-02,Debit Card,4.13,0.0,238545.36
2021-03-02,Commission,0.0,34077.91,204467.45
2021-03-02,Bill,3728.0,0.0,208195.45
2021-03-02,Tax,3465.0,0.0,211660.45
2021-03-02,Transfer,5.0,0.0,211665.45
2021-03-02,NEFT,0.0,35277.58,176387.88
2021-03-02,Cash,0.0,176387.88,0.0
2021-03-02,Debit Card,178104.72,0.0,178104.72
2021-03-02,Miscellaneous,0.0,44526.18,133578.54
2021-03-02,Reversal,235717.0,0.0,369295.54
2021-03-02,Interest,0.0,123098.51,246197.03
2021-03-02,NEFT,0.0,49239.41,196957.62
2021-03-02,NEFT,0.0,24619.7,172337.92
2021-03-02,Cheque,282.96,0.0,172620.88
2021-03-02,Tax,96672.0,0.0,269292.88
2021-03-02,Transfer,248.2,0.0,269541.08
2021-03-02,Debit Card,0.0,38505.87,231035.21
2021-03-02,RTGS,1342289.0,0.0,1573324.21
2021-03-02,Debit Card,0.0,524441.4,1048882.81
2021-03-02,Commission,0.0,1048882.81,0.0
2021-03-02,IMPS,29368.4,0.0,29368.4
2021-03-02,Interest,52.92,0.0,29421.32
2021-03-02,Miscellaneous,0.0,14710.66,14710.66
2021-03-02,Debit Card,0.0,2451.78,12258.88
2021-03-02,Purchase,0.0,2451.78,9807.1
2021-03-02,Tax,0.0,1089.68,8717.42
2021-03-02,Miscellaneous,0.0,1245.35,7472.07
2021-03-02,ATM,97864.59,0.0,105336.66
2021-03-02,Commission,0.0,105336.66,0.0
2021-03-02,Cheque,108218.2,0.0,108218.2
2021-03-02,Miscellaneous,1003788.0,0.0,1112006.2
2021-03-02,Cheque,0.0,370668.73,741337.47
2021-03-02,ATM,0.0,148267.49,593069.98
2021-03-02,Commission,0.0,65896.66,527173.32
2021-03-02,RTGS,0.0,263586.66,263586.66
2021-03-02,RTGS,0.0,37655.24,225931.42
2021-03-02,ATM,447816.5,0.0,673747.92
2021-03-02,Miscellaneous,0.0,336873.96,336873.96
2021-03-02,Purchase,1148546.0,0.0,1485419.96
2021-03-02,Cash,0.0,371354.99,1114064.97
2021-03-02,Cash,12.0,0.0,1114076.97
2021-03-02,Cash,0.0,1114076.97,0.0
2021-03-02,RTGS,364.0,0.0,364.0
2021-03-02,Debit Card,210.0,0.0,574.0
2021-03-02,Purchase,0.0,63.78,510.22
2021-03-02,Purchase,0.0,255.11,255.11
2021-03-02,Transfer,0.0,25.51,229.6
2021-03-02,NEFT,387.1,0.0,616.7
2021-03-02,Tax,47.71,0.0,664.41
2021-03-02,Cash,1.8,0.0,666.21
2021-03-02,Bill,3008.4,0.0,3674.61
2021-03-02,Commission,68387.0,0.0,72061.61
2021-03-02,Miscellaneous,0.0,18015.4,54046.21
2021-03-02,Cash,0.0,9007.7,45038.51
2021-03-02,Reversal,2994.5,0.0,48033.01
2021-03-02,Miscellaneous,0.0,6004.13,42028.88
2021-03-02,Commission,0.0,10507.22,31521.66
2021-03-02,Interest,30.0,0.0,31551.66
2021-03-02,Cheque,23914.0,0.0,55465.66
2021-03-02,IMPS,0.0,55465.66,0.0
2021-03-02,Reversal,1801418.0,0.0,1801418.0
2021-03-02,Debit Card,0.0,180141.8,1621276.2
2021-03-02,Commission,0.0,162127.62,1459148.58
2021-03-02,Reversal,0.0,208449.8,1250698.78
2021-03-02,Reversal,0.0,250139.76,1000559.02
2021-03-02,Reversal,0.0,100055.9,900503.12
2021-03-02,NEFT,0.0,180100.62,720402.5
2021-03-02,Reversal,0.0,120067.08,600335.42
2021-03-02,Reversal,0.0,200111.81,400223.61
2021-03-02,Interest,456888.2,0.0,857111.81
2021-03-02,Reversal,0.1,0.0,857111.91
2021-03-02,Commission,62974.72,0.0,920086.63
2021-03-02,Debit Card,50.75,0.0,920137.38
2021-03-02,NEFT,0.0,230034.35,690103.04
2021-03-02,Interest,0.0,690103.04,0.0
2021-03-02,Commission,0.0,0.0,0.0
2021-03-02,Transfer,202.5,0.0,202.5
2021-03-02,Cash,265.0,0.0,467.5
2021-03-02,NEFT,0.0,66.79,400.71
2021-03-02,Reversal,4.0,0.0,404.71
2021-03-02,Debit Card,11896.3,0.0,12301.01
2021-03-02,Commission,751.0,0.0,13052.01
2021-03-02,IMPS,0.0,1631.5,11420.51
2021-03-02,Interest,0.0,11420.51,0.0
2021-03-02,Cash,3027.0,0.0,3027.0
2021-03-02,Bill,7308.0,0.0,10335.0
2021-03-02,Cash,1535942.0,0.0,1546277.0
2021-03-02,ATM,33.54,0.0,1546310.54
2021-03-02,Tax,0.0,386577.64,1159732.9
2021-03-02,Purchase,0.0,165676.13,994056.77
2021-03-02,NEFT,0.0,994056.77,0.0
2021-03-02,Bill,3.9,0.0,3.9
2021-03-02,Cash,0.0,1.3,2.6
2021-03-02,Miscellaneous,3988.0,0.0,3990.6
2021-03-02,Cheque,0.0,798.12,3192.48
2021-03-02,IMPS,0.0,354.72,2837.76
2021-03-02,Reversal,0.0,709.44,2128.32
2021-03-02,Commission,7.25,0.0,2135.57
2021-03-02,Interest,0.0,266.95,1868.62
2021-03-02,RTGS,0.0,467.16,1401.46
2021-03-02,Interest,0.0,233.58,1167.88
2021-03-02,RTGS,0.0,166.84,1001.04
2021-03-02,NEFT,0.0,333.68,667.36
2021-03-02,Cheque,0.0,333.68,333.68
2021-03-02,Reversal,2019539.5,0.0,2019873.18
2021-03-02,ATM,34.0,0.0,2019907.18
2021-03-02,Cash,0.6,0.0,2019907.78
2021-03-02,Reversal,0.0,2019907.78,0.0
2021-03-02,IMPS,6605.23,0.0,6605.23
2021-03-02,Cash,106022.8,0.0,112628.03
2021-03-02,Debit Card,47.1,0.0,112675.13
2021-03-02,RTGS,1540.3,0.0,114215.43
2021-03-02,IMPS,14.57,0.0,114230.0
2021-03-02,RTGS,65923.16,0.0,180153.16
2021-03-02,Debit Card,0.0,180153.16,0.0
2021-03-02,NEFT,65.58,0.0,65.58
2021-03-02,Cash,1408804.5,0.0,1408870.08
2021-03-02,Cheque,2490.81,0.0,1411360.89
2021-03-02,NEFT,0.0,156817.88,1254543.01
2021-03-02,Tax,0.0,156817.88,1097725.13
2021-03-02,Transfer,12034.0,0.0,1109759.13
2021-03-02,Interest,195007.2,0.0,1304766.33
2021-03-02,Cheque,84553.1,0.0,1389319.43
2021-03-02,Tax,12242.2,0.0,1401561.63
2021-03-02,ATM,27878.0,0.0,1429439.63
2021-03-02,NEFT,0.0,142943.96,1286495.67
2021-03-02,IMPS,0.0,142943.96,1143551.71
2021-03-02,NEFT,40.68,0.0,1143592.39
2021-03-02,Miscellaneous,1807893.5,0.0,2951485.89
2021-03-02,IMPS,0.0,737871.47,2213614.42
2021-03-02,Purchase,0.0,276701.8,1936912.62
2021-03-02,Debit Card,0.0,215212.51,1721700.11
2021-03-02,Bill,0.0,191300.01,1530400.1
2021-03-02,Miscellaneous,46013.0,0.0,1576413.1
2021-03-02,IMPS,500.2,0.0,1576913.3
2021-03-02,Transfer,0.0,175212.59,1401700.71
2021-03-02,RTGS,0.0,280340.14,1121360.57
2021-03-03,Reversal,0.0,224272.11,897088.46
2021-03-03,Debit Card,2.55,0.0,897091.01
2021-03-03,Debit Card,8.0,0.0,897099.01
2021-03-03,IMPS,0.0,897099.01,0.0
2021-03-03,NEFT,288.11,0.0,288.11
2021-03-03,Purchase,134.5,0.0,422.61
2021-03-03,Reversal,14.37,0.0,436.98
2021-03-03,Transfer,0.0,436.98,0.0
2021-03-03,Cheque,385457.0,0.0,385457.0
2021-03-03,Interest,0.0,96364.25,289092.75
2021-03-03,ATM,7893.5,0.0,296986.25
2021-03-03,Tax,0.0,29698.63,267287.62
2021-03-03,Tax,0.0,53457.52,213830.1
2021-03-03,NEFT,3679.0,0.0,217509.1
2021-03-03,Debit Card,23.98,0.0,217533.08
2021-03-03,Purchase,0.0,217533.08,0.0
2021-03-03,Debit Card,1276247.0,0.0,1276247.0
2021-03-03,Cash,11176.5,0.0,1287423.5
2021-03-03,IMPS,249.67,0.0,1287673.17
2021-03-03,Cheque,4.11,0.0,1287677.28
2021-03-03,Reversal,125219.28,0.0,1412896.56
2021-03-03,RTGS,0.0,176612.07,1236284.49
2021-03-03,IMPS,1544759.8,0.0,2781044.29
2021-03-03,Miscellaneous,197550.0,0.0,2978594.29
2021-03-03,NEFT,8.0,0.0,2978602.29
2021-03-03,Purchase,0.0,1489301.15,1489301.14
2021-03-03,Purchase,26057.67,0.0,1515358.81
2021-03-03,Cheque,0.0,168373.2,1346985.61
2021-03-03,Reversal,1109120.2,0.0,2456105.81
2021-03-03,Miscellaneous,2052578.0,0.0,4508683.81
2021-03-03,NEFT,0.0,450868.38,4057815.43
2021-03-03,Purchase,0.0,405781.54,3652033.89
2021-03-03,Cheque,0.0,456504.24,3195529.65
2021-03-03,Interest,376.0,0.0,3195905.65
2021-03-03,IMPS,0.0,639181.13,2556724.52
2021-03-03,Interest,452606.5,0.0,3009331.02
2021-03-03,Interest,5.93,0.0,3009336.95
2021-03-03,Cheque,0.0,1003112.32,2006224.63
2021-03-03,Reversal,6.0,0.0,2006230.63
2021-03-03,Miscellaneous,44.7,0.0,2006275.33
2021-03-03,Cash,0.0,250784.42,1755490.91
2021-03-03,Commission,29.0,0.0,1755519.91
2021-03-03,NEFT,0.0,877759.96,877759.96
2021-03-03,Cheque,649172.5,0.0,1526932.46
2021-03-03,Cheque,0.0,254488.74,1272443.72
2021-03-03,ATM,0.0,212073.95,1060369.77
2021-03-03,Cash,0.0,353456.59,706913.18
2021-03-03,Miscellaneous,0.0,353456.59,353456.59
2021-03-03,Cash,59.26,0.0,353515.85
2021-03-03,Miscellaneous,0.0,39279.54,314236.31
2021-03-03,IMPS,0.0,52372.72,261863.59
2021-03-03,Tax,0.0,26186.36,235677.23
2021-03-03,RTGS,28.67,0.0,235705.9
2021-03-03,Debit Card,0.0,23570.59,212135.31
2021-03-03,Cash,0.0,21213.53,190921.78
2021-03-03,RTGS,0.0,23865.22,167056.56
2021-03-03,NEFT,155554.66,0.0,322611.22
2021-03-03,RTGS,177222.0,0.0,499833.22
2021-03-04,Purchase,0.0,55537.02,444296.2
2021-03-04,Cheque,16.65,0.0,444312.85
2021-03-04,Miscellaneous,0.0,88862.57,355450.28
2021-03-04,Commission,0.0,35545.03,319905.25
2021-03-04,Bill,110218.7,0.0,430123.95
2021-03-04,Miscellaneous,0.0,107530.99,322592.96
2021-03-04,Bill,0.0,107530.99,215061.97
2021-03-04,Miscellaneous,0.0,215061.97,0.0
2021-03-04,NEFT,11259.1,0.0,11259.1
2021-03-04,ATM,0.0,1876.52,9382.58
2021-03-04,Bill,0.0,1340.37,8042.21
2021-03-04,Purchase,476848.0,0.0,484890.21
2021-03-04,Debit Card,196283.5,0.0,681173.71
2021-03-04,Reversal,0.0,75685.97,605487.74
2021-03-04,NEFT,0.0,86498.25,518989.49
2021-03-04,ATM,0.0,259494.75,259494.74
2021-03-04,NEFT,294.35,0.0,259789.09
2021-03-04,IMPS,0.0,43298.18,216490.91
2021-03-04,Transfer,2094.7,0.0,218585.61
2021-03-04,Tax,0.0,31226.52,187359.09
2021-03-04,Cheque,0.0,187359.09,0.0
2021-03-04,Transfer,27.0,0.0,27.0
2021-03-04,IMPS,208400.9,0.0,208427.9
2021-03-04,RTGS,0.0,34737.98,173689.92
2021-03-04,Cash,12667.3,0.0,186357.22
2021-03-04,Interest,0.0,18635.72,167721.5
2021-03-04,Commission,0.0,27953.58,139767.92
2021-03-05,Cheque,677404.0,0.0,817171.92
2021-03-05,Cheque,456.0,0.0,817627.92
2021-03-05,Cash,0.0,116803.99,700823.93
2021-03-05,Cheque,3963.0,0.0,704786.93
2021-03-05,Transfer,0.0,352393.47,352393.46
2021-03-05,Interest,7.0,0.0,352400.46
2021-03-05,ATM,469.0,0.0,352869.46
2021-03-05,Miscellaneous,0.0,44108.68,308760.78
2021-03-05,Tax,0.0,38595.1,270165.68
2021-03-05,Reversal,27941.71,0.0,298107.39
2021-03-05,Cash,1.9,0.0,298109.29
2021-03-05,Debit Card,1406803.25,0.0,1704912.54
2021-03-05,Cash,0.0,189434.73,1515477.81
2021-03-05,Tax,624864.8,0.0,2140342.61
2021-03-05,Bill,3454.0,0.0,2143796.61
2021-03-05,Bill,0.0,1071898.31,1071898.3
2021-03-05,Tax,2559.8,0.0,1074458.1
2021-03-05,Cash,7.4,0.0,1074465.5
2021-03-05,RTGS,10.0,0.0,1074475.5
2021-03-05,NEFT,174671.2,0.0,1249146.7
2021-03-05,Bill,0.0,1249146.7,0.0
2021-03-05,Miscellaneous,19.0,0.0,19.0
2021-03-05,Debit Card,81425.0,0.0,81444.0
2021-03-05,IMPS,0.0,27148.0,54296.0
2021-03-05,Bill,3295.0,0.0,57591.0
2021-03-05,Cheque,1249.5,0.0,58840.5
2021-03-05,RTGS,0.0,8405.79,50434.71
2021-03-05,Tax,7.73,0.0,50442.44
2021-03-05,Tax,2.0,0.0,50444.44
2021-03-05,NEFT,176029.59,0.0,226474.03
2021-03-05,Debit Card,0.0,113237.02,113237.02
2021-03-05,Tax,0.0,18872.84,94364.18
2021-03-05,Debit Card,0.0,18872.84,75491.34
2021-03-05,ATM,227.0,0.0,75718.34
2021-03-05,RTGS,0.0,37859.17,37859.17
2021-03-05,Purchase,7.0,0.0,37866.17
2021-03-05,Miscellaneous,74171.88,0.0,112038.05
2021-03-05,Miscellaneous,4.0,0.0,112042.05
2021-03-05,IMPS,0.0,18673.68,93368.38
2021-03-05,Tax,6.0,0.0,93374.38
2021-03-05,NEFT,0.0,93374.38,0.0
2021-03-05,Interest,10448.72,0.0,10448.72
2021-03-06,Bill,0.0,2089.74,8358.98
2021-03-06,RTGS,0.0,1044.87,7314.11
2021-03-06,Transfer,0.0,3657.06,3657.06
2021-03-06,NEFT,0.0,1828.53,1828.53
2021-03-06,Tax,0.0,228.57,1599.96
2021-03-06,Purchase,461.3,0.0,2061.26
2021-03-06,NEFT,114.0,0.0,2175.26
2021-03-06,Purchase,0.0,2175.26,0.0
2021-03-06,Bill,259.63,0.0,259.63
2021-03-06,IMPS,35.6,0.0,295.23
2021-03-06,Commission,0.0,295.23,0.0
2021-03-06,Miscellaneous,27.4,0.0,27.4
2021-03-06,ATM,14659.0,0.0,14686.4
2021-03-06,Tax,3.0,0.0,14689.4
2021-03-06,Bill,0.0,1632.16,13057.24
2021-03-06,Transfer,0.0,1865.32,11191.92
2021-03-06,Debit Card,1135415.5,0.0,1146607.42
2021-03-06,Debit Card,0.0,573303.71,573303.71
2021-03-06,IMPS,46.7,0.0,573350.41
2021-03-06,Commission,0.0,286675.21,286675.2
2021-03-06,Purchase,1846.6,0.0,288521.8
2021-03-06,Commission,950.0,0.0,289471.8
2021-03-07,Miscellaneous,0.0,96490.6,192981.2
2021-03-07,Purchase,0.0,48245.3,144735.9
2021-03-07,IMPS,0.0,144735.9,0.0
2021-03-07,NEFT,59.76,0.0,59.76
2021-03-07,Cheque,53.7,0.0,113.46
2021-03-07,Miscellaneous,36.0,0.0,149.46
2021-03-07,Debit Card,0.0,16.61,132.85
2021-03-07,Reversal,0.0,44.28,88.57
2021-03-07,Cash,0.0,12.65,75.92
2021-03-07,Miscellaneous,46.84,0.0,122.76
2021-03-07,Cash,0.0,15.35,107.42
2021-03-07,IMPS,0.0,26.86,80.56
2021-03-07,RTGS,0.0,16.11,64.45
2021-03-07,Reversal,2058.53,0.0,2122.98
2021-03-07,Cheque,0.67,0.0,2123.65
2021-03-07,Transfer,0.0,303.38,1820.27
2021-03-07,Cheque,49.3,0.0,1869.57
2021-03-07,ATM,436.7,0.0,2306.27
2021-03-07,Miscellaneous,0.0,329.47,1976.8
2021-03-07,Cheque,0.0,1976.8,0.0
2021-03-07,Purchase,231924.38,0.0,231924.38
2021-03-07,Debit Card,2445.0,0.0,234369.38
2021-03-07,Cash,0.0,33481.34,200888.04
2021-03-07,Commission,0.0,25111.01,175777.04
2021-03-07,RTGS,0.0,29296.17,146480.87
2021-03-07,Tax,0.0,16275.65,130205.22
2021-03-07,Interest,7.04,0.0,130212.26
2021-03-07,Purchase,0.0,43404.09,86808.17
2021-03-07,NEFT,0.0,12401.17,74407.0
2021-03-07,Bill,0.0,10629.57,63777.43
2021-03-07,Tax,0.0,10629.57,53147.86
2021-03-07,Reversal,595986.25,0.0,649134.11
2021-03-07,IMPS,8530.56,0.0,657664.67
2021-03-07,Interest,66102.0,0.0,723766.67
2021-03-07,Commission,88613.5,0.0,812380.17
2021-03-07,ATM,6766.66,0.0,819146.83
2021-03-07,Cheque,36.0,0.0,819182.83
2021-03-08,RTGS,0.0,102397.85,716784.98
2021-03-08,Cash,5.0,0.0,716789.98
2021-03-09,ATM,1334.0,0.0,718123.98
2021-03-10,Interest,1.43,0.0,718125.41
2021-03-10,NEFT,0.0,102589.34,615536.07
2021-03-10,RTGS,0.0,68392.9,547143.17
2021-03-10,RTGS,0.0,547143.17,0.0
2021-03-10,Purchase,5.27,0.0,5.27
2021-03-10,Debit Card,0.0,1.76,3.51
2021-03-10,Bill,0.0,0.59,2.92
2021-03-10,Miscellaneous,12.0,0.0,14.92
2021-03-10,Interest,4930.0,0.0,4944.92
2021-03-10,ATM,0.85,0.0,4945.77
2021-03-10,NEFT,6499.27,0.0,11445.04
2021-03-10,NEFT,0.0,1144.5,10300.54
2021-03-10,RTGS,59311.0,0.0,69611.54
2021-03-10,ATM,0.0,9944.51,59667.03
2021-03-10,RTGS,0.0,7458.38,52208.65
2021-03-10,Purchase,8.2,0.0,52216.85
2021-03-10,Transfer,1468038.0,0.0,1520254.85
2021-03-11,Commission,375.0,0.0,1520629.85
2021-03-11,Transfer,26.0,0.0,1520655.85
2021-03-11,Tax,50.49,0.0,1520706.34
2021-03-11,Debit Card,0.0,168967.37,1351738.97
2021-03-11,Purchase,0.0,150193.22,1201545.75
2021-03-11,IMPS,23356.3,0.0,1224902.05
2021-03-11,Interest,4.0,0.0,1224906.05
2021-03-11,Cheque,0.0,306226.51,918679.54
2021-03-11,Tax,0.0,918679.54,0.0
2021-03-11,Tax,240175.69,0.0,240175.69
2021-03-11,Miscellaneous,439.0,0.0,240614.69
2021-03-11,Interest,0.0,80204.9,160409.79
2021-03-11,NEFT,461.69,0.0,160871.48
2021-03-11,Reversal,0.0,20108.94,140762.55
2021-03-11,RTGS,298000.25,0.0,438762.8
2021-03-11,Cheque,1061618.0,0.0,1500380.8
2021-03-11,RTGS,0.0,214340.11,1286040.69
2021-03-11,Bill,240.0,0.0,1286280.69
2021-03-11,Tax,0.0,183754.38,1102526.31
2021-03-11,Reversal,121220.0,0.0,1223746.31
2021-03-11,Reversal,0.0,611873.16,611873.16
2021-03-11,Cheque,0.0,61187.32,550685.84
2021-03-11,Miscellaneous,1003.0,0.0,551688.84
2021-03-11,Debit Card,1503976.0,0.0,2055664.84
2021-03-11,ATM,35.26,0.0,2055700.1
2021-03-11,IMPS,0.0,2055700.1,0.0
2021-03-11,Interest,58.2,0.0,58.2
2021-03-11,Purchase,0.0,6.47,51.73
2021-03-11,Reversal,0.0,51.73,0.0
2021-03-11,Cheque,25.76,0.0,25.76
2021-03-11,Bill,5801.0,0.0,5826.76
2021-03-11,Reversal,8.0,0.0,5834.76
2021-03-11,ATM,7.74,0.0,5842.5
2021-03-11,Tax,0.0,649.17,5193.33
2021-03-11,Debit Card,0.0,741.9,4451.43
2021-03-11,Tax,60.88,0.0,4512.31
2021-03-11,NEFT,0.0,752.05,3760.26
2021-03-11,ATM,0.0,376.03,3384.23
2021-03-11,Debit Card,0.0,564.04,2820.19
2021-03-11,Reversal,0.0,705.05,2115.14
2021-03-11,Transfer,2.64,0.0,2117.78
2021-03-11,Tax,0.0,423.56,1694.22
2021-03-11,NEFT,0.0,847.11,847.11
2021-03-11,Commission,0.0,141.19,705.92
2021-03-11,Cheque,0.0,100.85,605.07
2021-03-11,NEFT,0.0,86.44,518.63
2021-03-11,RTGS,1337.33,0.0,1855.96
2021-03-11,Debit Card,0.0,463.99,1391.97
2021-03-11,NEFT,88412.7,0.0,89804.67
2021-03-11,Purchase,0.0,17960.93,71843.74
2021-03-11,Tax,1999179.25,0.0,2071022.99
2021-03-11,IMPS,0.0,295860.43,1775162.56
2021-03-11,Commission,409.2,0.0,1775571.76
2021-03-11,Debit Card,0.0,177557.18,1598014.58
2021-03-11,Reversal,0.0,266335.76,1331678.82
2021-03-11,Transfer,0.0,190239.83,1141438.99
2021-03-11,Cheque,0.0,114143.9,1027295.09
2021-03-11,Reversal,230128.2,0.0,1257423.29
2021-03-11,Debit Card,0.0,157177.91,1100245.38
2021-03-11,IMPS,34.63,0.0,1100280.01
2021-03-11,Transfer,3.55,0.0,1100283.56
2021-03-11,Miscellaneous,1649.12,0.0,1101932.68
2021-03-11,Interest,44.0,0.0,1101976.68
2021-03-11,Commission,18054.75,0.0,1120031.43
2021-03-11,Bill,2.7,0.0,1120034.13
2021-03-11,Purchase,0.0,1120034.13,0.0
2021-03-11,Commission,1250839.2,0.0,1250839.2
2021-03-11,Interest,0.0,138982.13,1111857.07
2021-03-11,Bill,944996.8,0.0,2056853.87
2021-03-11,Debit Card,3443.29,0.0,2060297.16
2021-03-11,Interest,3.0,0.0,2060300.16
2021-03-11,Cash,0.0,228922.24,1831377.92
2021-03-11,Purchase,254303.0,0.0,2085680.92
2021-03-11,RTGS,1148.09,0.0,2086829.01
2021-03-11,Miscellaneous,0.0,260853.63,1825975.38
2021-03-11,Transfer,1051.5,0.0,1827026.88
2021-03-11,Tax,7.0,0.0,1827033.88
2021-03-11,Cash,25.0,0.0,1827058.88
2021-03-11,Miscellaneous,0.0,456764.72,1370294.16
2021-03-11,Interest,0.0,274058.83,1096235.33
2021-03-11,RTGS,281.0,0.0,1096516.33
2021-03-11,Transfer,0.0,219303.27,877213.06
2021-03-11,Debit Card,0.0,125316.15,751896.91
2021-03-11,Tax,29167.2,0.0,781064.11
2021-03-11,Tax,0.0,781064.11,0.0
2021-03-11,Bill,106327.81,0.0,106327.81
2021-03-11,Cash,29821.0,0.0,136148.81
2021-03-11,Transfer,0.0,27229.76,108919.05
2021-03-11,RTGS,76.0,0.0,108995.05
2021-03-11,Tax,29.65,0.0,109024.7
2021-03-11,NEFT,0.0,36341.57,72683.13
2021-03-11,Tax,0.0,72683.13,0.0
2021-03-11,NEFT,5.0,0.0,5.0
2021-03-11,Miscellaneous,129362.6,0.0,129367.6
2021-03-11,Tax,0.0,32341.9,97025.7
2021-03-11,Tax,6.7,0.0,97032.4
2021-03-11,Interest,0.0,16172.07,80860.33
2021-03-11,NEFT,151997.9,0.0,232858.23
2021-03-11,IMPS,167.86,0.0,233026.09
2021-03-11,Transfer,362681.0,0.0,595707.09
2021-03-11,ATM,85807.59,0.0,681514.68
2021-03-11,Reversal,16676.0,0.0,698190.68
2021-03-11,Cash,1837.2,0.0,700027.88
2021-03-11,Purchase,23904.0,0.0,723931.88
2021-03-11,Miscellaneous,346.88,0.0,724278.76
2021-03-11,Reversal,0.0,241426.25,482852.51
2021-03-11,Interest,0.0,160950.84,321901.67
2021-03-11,Debit Card,81.0,0.0,321982.67
2021-03-11,Commission,0.0,107327.56,214655.11
2021-03-11,Transfer,0.0,35775.85,178879.26
2021-03-11,Purchase,0.0,17887.93,160991.33
2021-03-11,Bill,2320.0,0.0,163311.33
2021-03-11,Interest,0.0,163311.33,0.0
2021-03-11,Interest,1087.8,0.0,1087.8
2021-03-11,Miscellaneous,5.0,0.0,1092.8
2021-03-11,Bill,0.0,1092.8,0.0
2021-03-11,NEFT,1552265.0,0.0,1552265.0
2021-03-11,ATM,0.0,155226.5,1397038.5
2021-03-12,IMPS,49086.25,0.0,1446124.75
2021-03-12,Miscellaneous,0.1,0.0,1446124.85
2021-03-12,Debit Card,1134235.75,0.0,2580360.6
2021-03-12,Cash,0.0,430060.1,2150300.5
2021-03-12,Reversal,0.0,2150300.5,0.0
2021-03-13,NEFT,130.4,0.0,130.4
2021-03-13,Cash,0.0,32.6,97.8
2021-03-13,Commission,0.0,19.56,78.24
2021-03-13,Debit Card,152100.0,0.0,152178.24
2021-03-13,ATM,506.12,0.0,152684.36
2021-03-13,Cash,950945.75,0.0,1103630.11
2021-03-13,Interest,0.0,275907.53,827722.58
2021-03-13,Purchase,5.0,0.0,827727.58
2021-03-13,ATM,48.38,0.0,827775.96
2021-03-13,Transfer,0.0,82777.6,744998.36
2021-03-13,Cheque,1479490.5,0.0,2224488.86
2021-03-13,Commission,0.0,278061.11,1946427.75
2021-03-13,Transfer,1383644.0,0.0,3330071.75
2021-03-13,Cheque,6628.6,0.0,3336700.35
2021-03-13,Tax,4347.46,0.0,3341047.81
2021-03-13,IMPS,0.0,556841.3,2784206.51
2021-03-13,Reversal,256600.88,0.0,3040807.39
2021-03-13,Debit Card,0.0,506801.23,2534006.16
2021-03-13,Interest,30824.38,0.0,2564830.54
2021-03-13,Debit Card,0.0,284981.17,2279849.37
2021-03-13,Cash,0.0,455969.87,1823879.5
2021-03-13,Reversal,1020461.8,0.0,2844341.3
2021-03-13,Purchase,2664.5,0.0,2847005.8
2021-03-13,Commission,14544.0,0.0,2861549.8
2021-03-13,Commission,0.0,357693.73,2503856.07
2021-03-13,IMPS,248.0,0.0,2504104.07
2021-03-13,Interest,127470.0,0.0,2631574.07
2021-03-13,IMPS,21537.35,0.0,2653111.42
2021-03-13,Bill,3273.0,0.0,2656384.42
2021-03-13,Reversal,0.0,885461.47,1770922.95
2021-03-13,Miscellaneous,56.01,0.0,1770978.96
2021-03-13,Tax,0.0,177097.9,1593881.06
2021-03-13,Reversal,0.0,398470.27,1195410.8
2021-03-13,ATM,23.5,0.0,1195434.3
2021-03-13,ATM,0.0,119543.43,1075890.87
2021-03-13,Transfer,1858.4,0.0,1077749.27
2021-03-13,Cheque,0.0,359249.76,718499.51
2021-03-13,NEFT,0.0,89812.44,628687.07
2021-03-13,Purchase,0.0,628687.07,0.0
2021-03-13,ATM,6419.0,0.0,6419.0
2021-03-13,ATM,0.0,1604.75,4814.25
2021-03-13,Purchase,0.0,4814.25,0.0
2021-03-13,Purchase,11.54,0.0,11.54
2021-03-13,Tax,7.0,0.0,18.54
2021-03-13,Purchase,13606.8,0.0,13625.34
2021-03-13,Bill,0.0,4541.78,9083.56
2021-03-13,Purchase,0.0,1297.65,7785.91
2021-03-13,Purchase,0.0,1946.48,5839.43
2021-03-13,Cheque,0.0,1167.89,4671.54
2021-03-13,Purchase,0.0,934.31,3737.23
2021-03-13,RTGS,0.0,1245.74,2491.49
2021-03-13,IMPS,0.0,276.83,2214.66
2021-03-13,Transfer,0.0,246.07,1968.59
2021-03-13,Tax,365.0,0.0,2333.59
2021-03-13,Debit Card,0.0,583.4,1750.19
2021-03-13,Cash,0.0,175.02,1575.17
2021-03-13,Debit Card,217579.0,0.0,219154.17
2021-03-13,Bill,0.0,219154.17,0.0
2021-03-13,Reversal,20695.1,0.0,20695.1
2021-03-13,NEFT,0.0,3449.18,17245.92
2021-03-13,Tax,55524.0,0.0,72769.92
2021-03-13,Cash,3738.4,0.0,76508.32
2021-03-13,Reversal,103.0,0.0,76611.32
2021-03-13,Purchase,50.2,0.0,76661.52
2021-03-13,NEFT,183057.0,0.0,259718.52
2021-03-13,Cash,865919.0,0.0,1125637.52
2021-03-13,Reversal,212596.0,0.0,1338233.52
2021-03-13,Reversal,150.0,0.0,1338383.52
2021-03-13,Transfer,962454.0,0.0,2300837.52
2021-03-13,Debit Card,195793.8,0.0,2496631.32
2021-03-13,Bill,109503.0,0.0,2606134.32
2021-03-14,Transfer,0.0,289570.48,2316563.84
2021-03-14,Bill,20193.0,0.0,2336756.84
2021-03-14,Tax,78456.6,0.0,2415213.44
2021-03-14,Transfer,0.0,345030.49,2070182.95
2021-03-14,Commission,0.0,258772.87,1811410.08
2021-03-14,Reversal,381.91,0.0,1811791.99
2021-03-14,IMPS,2884.0,0.0,1814675.99
2021-03-14,NEFT,242.0,0.0,1814917.99
2021-03-14,Debit Card,0.0,453729.5,1361188.49
2021-03-15,Cash,0.0,340297.12,1020891.37
2021-03-15,Interest,6.5,0.0,1020897.87
2021-03-15,Reversal,0.0,255224.47,765673.4
2021-03-15,Cheque,1559456.0,0.0,2325129.4
2021-03-15,Cheque,128640.0,0.0,2453769.4
2021-03-15,Interest,0.0,490753.88,1963015.52
2021-03-15,NEFT,1.0,0.0,1963016.52
2021-03-15,Purchase,0.0,196301.65,1766714.87
2021-03-15,IMPS,0.18,0.0,1766715.05
2021-03-15,Reversal,2.1,0.0,1766717.15
2021-03-15,Cash,0.0,883358.58,883358.58
2021-03-15,Commission,127537.0,0.0,1010895.58
2021-03-15,Miscellaneous,94719.0,0.0,1105614.58
2021-03-15,RTGS,0.0,368538.19,737076.39
2021-03-15,Cheque,0.0,245692.13,491384.26
2021-03-15,Transfer,52813.0,0.0,544197.26
2021-03-15,ATM,0.0,60466.36,483730.9
2021-03-15,Interest,0.0,161243.63,322487.27
2021-03-15,Tax,392.0,0.0,322879.27
2021-03-15,Purchase,3.0,0.0,322882.27
2021-03-15,Reversal,141.15,0.0,323023.42
2021-03-15,Interest,0.0,80755.86,242267.56
2021-03-15,Purchase,953.7,0.0,243221.26
2021-03-15,Tax,0.0,81073.75,162147.51
2021-03-15,ATM,25.0,0.0,162172.51
2021-03-15,ATM,37.0,0.0,162209.51
2021-03-15,NEFT,494.14,0.0,162703.65
2021-03-15,Miscellaneous,0.0,16270.37,146433.28
2021-03-15,Interest,3.21,0.0,146436.49
2021-03-15,Miscellaneous,0.0,73218.25,73218.24
2021-03-15,Bill,118428.69,0.0,191646.93
2021-03-15,Commission,786485.25,0.0,978132.18
2021-03-15,Bill,0.0,195626.44,782505.74
2021-03-15,Cash,82804.3,0.0,865310.04
2021-03-15,Interest,0.0,96145.56,769164.48
2021-03-15,Miscellaneous,0.0,384582.24,384582.24
2021-03-15,Cash,1.26,0.0,384583.5
2021-03-15,Transfer,0.0,76916.7,307666.8
2021-03-15,Tax,1389819.5,0.0,1697486.3
2021-03-15,Transfer,0.0,1697486.3,0.0
2021-03-15,Cheque,36.94,0.0,36.94
2021-03-16,Commission,0.0,4.1,32.84
2021-03-16,Transfer,0.0,3.65,29.19
2021-03-16,Commission,745.0,0.0,774.19
2021-03-16,Cheque,864.4,0.0,1638.59
2021-03-16,Reversal,0.0,1638.59,0.0
2021-03-16,NEFT,27726.3,0.0,27726.3
2021-03-16,Cheque,0.0,2772.63,24953.67
2021-03-16,RTGS,4.3,0.0,24957.97
2021-03-16,Miscellaneous,314.42,0.0,25272.39
2021-03-16,IMPS,146825.6,0.0,172097.99
2021-03-16,Reversal,0.0,43024.5,129073.49
2021-03-16,IMPS,3.84,0.0,129077.33
2021-03-17,Commission,0.0,43025.78,86051.55
2021-03-17,Debit Card,0.0,28683.85,57367.7
2021-03-17,Cheque,0.0,19122.57,38245.13
2021-03-17,Commission,0.0,7649.03,30596.1
2021-03-17,Interest,289.5,0.0,30885.6
2021-03-17,Transfer,203156.31,0.0,234041.91
2021-03-17,Reversal,0.0,58510.48,175531.43
2021-03-17,Reversal,68.0,0.0,175599.43
2021-03-17,NEFT,243.0,0.0,175842.43
2021-03-17,IMPS,1238.12,0.0,177080.55
2021-03-17,IMPS,0.0,88540.28,88540.28
2021-03-18,Purchase,14760.61,0.0,103300.89
2021-03-18,Cash,47.0,0.0,103347.89
2021-03-19,Commission,2590.0,0.0,105937.89
2021-03-19,Commission,0.0,10593.79,95344.1
2021-03-19,Tax,19238.8,0.0,114582.9
2021-03-19,Debit Card,0.0,22916.58,91666.32
2021-03-19,Debit Card,206026.0,0.0,297692.32
2021-03-19,RTGS,0.0,297692.32,0.0
2021-03-19,ATM,2981.43,0.0,2981.43
2021-03-19,ATM,0.0,596.29,2385.14
2021-03-19,Bill,0.0,477.03,1908.11
2021-03-19,Commission,104278.8,0.0,106186.91
2021-03-19,Transfer,0.0,17697.82,88489.09
2021-03-19,IMPS,157.04,0.0,88646.13
2021-03-19,ATM,42.0,0.0,88688.13
2021-03-19,NEFT,0.0,9854.24,78833.89
2021-03-19,Tax,33.8,0.0,78867.69
2021-03-19,Commission,1101.39,0.0,79969.08
2021-03-19,Purchase,0.0,7996.91,71972.17
2021-03-19,Cash,29.94,0.0,72002.11
2021-03-19,ATM,0.0,8000.23,64001.88
2021-03-19,Debit Card,0.0,10666.98,53334.9
2021-03-20,Debit Card,0.0,26667.45,26667.45
2021-03-20,Commission,4.0,0.0,26671.45
2021-03-20,Debit Card,0.0,6667.86,20003.59
2021-03-20,Debit Card,0.0,20003.59,0.0
2021-03-20,Cheque,6.9,0.0,6.9
2021-03-20,NEFT,0.0,1.15,5.75
2021-03-20,Debit Card,0.0,0.82,4.93
2021-03-20,Transfer,11042.5,0.0,11047.43
2021-03-20,Debit Card,0.0,1380.93,9666.5
2021-03-20,RTGS,0.0,2416.63,7249.88
2021-03-20,Commission,242687.0,0.0,249936.88
2021-03-20,IMPS,6.5,0.0,249943.38
2021-03-20,Commission,0.0,62485.85,187457.54
2021-03-20,IMPS,25885.63,0.0,213343.17
2021-03-20,Interest,0.0,35557.2,177785.98
2021-03-20,Reversal,5455.0,0.0,183240.98
2021-03-20,Cash,1.7,0.0,183242.68
2021-03-20,Interest,26104.0,0.0,209346.68
2021-03-20,Cash,5.92,0.0,209352.6
2021-03-20,Commission,7.0,0.0,209359.6
2021-03-20,Interest,195556.81,0.0,404916.41
2021-03-20,Commission,0.0,44990.71,359925.7
2021-03-20,NEFT,0.0,359925.7,0.0
2021-03-20,Purchase,2023723.75,0.0,2023723.75
2021-03-20,Purchase,0.0,404744.75,1618979.0
2021-03-21,RTGS,20972.8,0.0,1639951.8
2021-03-21,Interest,0.0,273325.3,1366626.5
2021-03-21,Cheque,0.0,136662.65,1229963.85
2021-03-21,Cheque,22035.9,0.0,1251999.75
2021-03-21,Cheque,0.0,417333.25,834666.5
2021-03-21,ATM,3.0,0.0,834669.5
2021-03-21,Cash,0.0,83466.95,751202.55
2021-03-21,IMPS,0.0,93900.32,657302.23
2021-03-21,Interest,459.18,0.0,657761.41
2021-03-21,Reversal,467.8,0.0,658229.21
2021-03-21,Debit Card,0.0,82278.65,575950.56
2021-03-21,Cheque,0.0,57595.06,518355.5
2021-03-21,Miscellaneous,3.7,0.0,518359.2
2021-03-21,ATM,1720812.0,0.0,2239171.2
2021-03-21,Miscellaneous,0.0,373195.2,1865976.0
2021-03-21,Commission,39.65,0.0,1866015.65
2021-03-21,Miscellaneous,7.0,0.0,1866022.65
2021-03-21,NEFT,12.8,0.0,1866035.45
2021-03-21,Debit Card,2.4,0.0,1866037.85
2021-03-21,Purchase,6.2,0.0,1866044.05
2021-03-21,NEFT,15448.0,0.0,1881492.05
2021-03-21,IMPS,0.0,235186.51,1646305.54
2021-03-21,Miscellaneous,0.0,329261.11,1317044.43
2021-03-21,NEFT,186400.44,0.0,1503444.87
2021-03-21,Purchase,60.6,0.0,1503505.47
2021-03-21,Cash,0.0,167056.16,1336449.31
2021-03-21,IMPS,0.0,1336449.31,0.0
2021-03-21,IMPS,106928.0,0.0,106928.0
2021-03-21,IMPS,0.0,26732.0,80196.0
2021-03-21,Commission,967512.0,0.0,1047708.0
2021-03-21,IMPS,0.0,174618.0,873090.0
2021-03-21,ATM,2.6,0.0,873092.6
2021-03-21,Cash,0.0,873092.6,0.0
2021-03-21,NEFT,3.07,0.0,3.07
2021-03-21,Purchase,14315.86,0.0,14318.93
2021-03-21,Tax,16053.3,0.0,30372.23
2021-03-21,Purchase,0.0,4338.89,26033.34
2021-03-21,Transfer,7.4,0.0,26040.74
2021-03-21,RTGS,0.0,8680.25,17360.49
2021-03-21,RTGS,0.0,1928.94,15431.55
2021-03-21,Bill,0.0,15431.55,0.0
2021-03-21,Reversal,20.3,0.0,20.3
2021-03-21,RTGS,0.0,5.08,15.23
2021-03-21,Reversal,0.0,1.69,13.54
2021-03-21,Bill,3120.0,0.0,3133.54
2021-03-21,Commission,9083.1,0.0,12216.64
2021-03-21,Commission,0.0,1527.08,10689.56
2021-03-21,Cheque,0.0,1781.59,8907.97
2021-03-21,RTGS,0.0,2969.32,5938.65
2021-03-21,Bill,0.0,1187.73,4750.92
2021-03-21,Cash,7.64,0.0,4758.56
2021-03-21,Interest,42.7,0.0,4801.26
2021-03-21,RTGS,3014.0,0.0,7815.26
2021-03-21,Debit Card,8.0,0.0,7823.26
2021-03-21,Debit Card,0.0,782.33,7040.93
2021-03-21,IMPS,53.18,0.0,7094.11
2021-03-21,Bill,0.0,2364.7,4729.41
2021-03-21,Cheque,7.0,0.0,4736.41
2021-03-21,Bill,942153.0,0.0,946889.41
2021-03-21,Cheque,0.0,315629.8,631259.61
2021-03-21,IMPS,5.0,0.0,631264.61
2021-03-21,ATM,39.16,0.0,631303.77
2021-03-21,RTGS,169195.0,0.0,800498.77
2021-03-21,Commission,0.0,800498.77,0.0
2021-03-21,Commission,197580.16,0.0,197580.16
2021-03-21,Cheque,385.23,0.0,197965.39
2021-03-21,Commission,0.0,39593.08,158372.31
2021-03-21,Cheque,76.0,0.0,158448.31
2021-03-21,Bill,0.0,15844.83,142603.48
2021-03-21,RTGS,1.4,0.0,142604.88
2021-03-21,Transfer,34156.22,0.0,176761.1
2021-03-21,NEFT,5.0,0.0,176766.1
2021-03-21,Debit Card,5.9,0.0,176772.0
2021-03-21,Commission,0.0,22096.5,154675.5
2021-03-21,Reversal,3200.2,0.0,157875.7
2021-03-21,ATM,2.4,0.0,157878.1
2021-03-21,Cheque,841.9,0.0,158720.0
2021-03-21,Interest,0.0,17635.56,141084.44
2021-03-21,IMPS,27079.6,0.0,168164.04
2021-03-21,Interest,0.0,33632.81,134531.23
2021-03-21,Reversal,0.0,26906.25,107624.98
2021-03-21,Bill,0.0,15375.0,92249.98
2021-03-21,Miscellaneous,0.0,15375.0,76874.98
2021-03-21,Cheque,0.0,9609.37,67265.61
2021-03-21,Purchase,0.0,16816.4,50449.21
2021-03-21,Miscellaneous,0.0,5044.92,45404.29
2021-03-21,ATM,14187.71,0.0,59592.0
2021-03-21,RTGS,0.0,6621.33,52970.67
2021-03-21,Interest,0.0,8828.45,44142.22
2021-03-21,Transfer,0.0,8828.44,35313.78
2021-03-21,IMPS,503.0,0.0,35816.78
2021-03-21,Tax,0.0,3581.68,32235.1
2021-03-21,Cash,0.0,6447.02,25788.08
2021-03-21,IMPS,0.0,8596.03,17192.05
2021-03-21,Bill,0.0,1910.23,15281.82
2021-03-21,Debit Card,25.97,0.0,15307.79
2021-03-21,Cash,159103.2,0.0,174410.99
2021-03-21,Miscellaneous,870771.0,0.0,1045181.99
2021-03-21,Commission,1571623.0,0.0,2616804.99
2021-03-21,Cheque,1627.01,0.0,2618432.0
2021-03-21,Miscellaneous,0.0,261843.2,2356588.8
2021-03-21,IMPS,0.0,392764.8,1963824.0
2021-03-21,Commission,1738.24,0.0,1965562.24
2021-03-21,RTGS,65387.94,0.0,2030950.18
2021-03-21,Transfer,193588.0,0.0,2224538.18
2021-03-21,RTGS,0.0,1112269.09,1112269.09
2021-03-21,Debit Card,168910.0,0.0,1281179.09
2021-03-21,Interest,0.0,128117.91,1153061.18
2021-03-21,Miscellaneous,142860.0,0.0,1295921.18
2021-03-21,Interest,0.0,647960.59,647960.59
2021-03-21,NEFT,0.0,129592.12,518368.47
2021-03-21,RTGS,454.0,0.0,518822.47
2021-03-21,Miscellaneous,11.9,0.0,518834.37
2021-03-21,Transfer,0.0,103766.87,415067.5
2021-03-21,RTGS,0.0,51883.44,363184.06
2021-03-21,Cash,1788208.0,0.0,2151392.06
2021-03-21,IMPS,56.9,0.0,2151448.96
2021-03-21,RTGS,0.0,430289.79,1721159.17
2021-03-21,Reversal,0.0,245879.88,1475279.29
2021-03-21,Cash,0.4,0.0,1475279.69
2021-03-21,Bill,15089.7,0.0,1490369.39
2021-03-21,Cheque,180.9,0.0,1490550.29
2021-03-21,NEFT,0.0,372637.57,1117912.72
2021-03-21,Reversal,0.0,279478.18,838434.54
2021-03-21,IMPS,140213.78,0.0,978648.32
2021-03-21,Reversal,0.9,0.0,978649.22
2021-03-21,Purchase,0.0,978649.22,0.0
2021-03-21,Miscellaneous,362.98,0.0,362.98
2021-03-21,Transfer,10630.3,0.0,10993.28
2021-03-21,Bill,0.0,5496.64,5496.64
2021-03-21,Debit Card,0.0,5496.64,0.0
2021-03-21,Cash,2070108.5,0.0,2070108.5
2021-03-21,Cash,253.25,0.0,2070361.75
2021-03-21,NEFT,222410.8,0.0,2292772.55
2021-03-21,Purchase,3475.0,0.0,2296247.55
2021-03-21,Commission,0.0,1148123.78,1148123.77
2021-03-21,Debit Card,404.0,0.0,1148527.77
2021-03-21,Bill,2.52,0.0,1148530.29
2021-03-21,Miscellaneous,46.79,0.0,1148577.08
2021-03-21,IMPS,23883.0,0.0,1172460.08
2021-03-21,Debit Card,271.3,0.0,1172731.38
2021-03-21,Purchase,0.0,1172731.38,0.0
2021-03-21,Cash,26.0,0.0,26.0
2021-03-21,Transfer,46.0,0.0,72.0
2021-03-22,NEFT,30571.7,0.0,30643.7
2021-03-22,Purchase,190374.88,0.0,221018.58
2021-03-22,Commission,0.0,55254.65,165763.94
2021-03-22,Cash,0.0,23680.56,142083.38
2021-03-22,Bill,33.8,0.0,142117.18
2021-03-22,Purchase,0.0,71058.59,71058.59
2021-03-22,Miscellaneous,1918.56,0.0,72977.15
2021-03-22,Miscellaneous,0.0,24325.72,48651.43
2021-03-22,Cheque,0.0,5405.71,43245.72
2021-03-22,Transfer,0.0,10811.43,32434.29
2021-03-22,Debit Card,21.9,0.0,32456.19
2021-03-22,RTGS,0.0,32456.19,0.0
2021-03-22,Miscellaneous,20441.1,0.0,20441.1
2021-03-22,Bill,391.0,0.0,20832.1
2021-03-22,Cheque,503.79,0.0,21335.89
2021-03-22,Transfer,388.69,0.0,21724.58
2021-03-22,IMPS,0.0,3103.51,18621.07
2021-03-22,Interest,20404.55,0.0,39025.62
2021-03-22,Bill,0.0,13008.54,26017.08
2021-03-22,Commission,341.92,0.0,26359.0
2021-03-22,Bill,0.0,8786.33,17572.67
2021-03-22,Debit Card,1607982.0,0.0,1625554.67
2021-03-22,Cheque,0.0,812777.34,812777.34
2021-03-22,Cheque,0.0,203194.34,609583.0
2021-03-23,Debit Card,5.1,0.0,609588.1
2021-03-23,Transfer,8.0,0.0,609596.1
2021-03-23,Cheque,0.0,76199.51,533396.59
2021-03-23,Tax,1.9,0.0,533398.49
2021-03-23,IMPS,238642.28,0.0,772040.77
2021-03-23,Reversal,1457.1,0.0,773497.87
2021-03-23,RTGS,3.38,0.0,773501.25
2021-03-23,ATM,0.0,110500.18,663001.07
2021-03-23,Interest,0.0,663001.07,0.0
2021-03-23,Transfer,635.53,0.0,635.53
2021-03-23,Tax,5618.0,0.0,6253.53
2021-03-23,Reversal,0.0,625.35,5628.18
2021-03-23,Cheque,0.0,804.03,4824.15
2021-03-23,Reversal,0.0,482.42,4341.73
2021-03-23,Cheque,0.0,868.35,3473.38
2021-03-23,Tax,0.0,868.35,2605.04
2021-03-23,Commission,0.0,651.26,1953.78
2021-03-23,RTGS,0.0,651.26,1302.52
2021-03-23,Interest,0.0,186.07,1116.45
2021-03-23,NEFT,4518.8,0.0,5635.25
2021-03-23,Miscellaneous,0.0,1127.05,4508.2
2021-03-23,NEFT,13.8,0.0,4522.0
2021-03-23,Reversal,0.0,1130.5,3391.5
2021-03-23,Cheque,0.0,847.88,2543.62
2021-03-23,Debit Card,180.0,0.0,2723.62
2021-03-23,ATM,0.0,389.09,2334.53
2021-03-23,Transfer,226542.0,0.0,228876.53
2021-03-23,Transfer,0.0,114438.27,114438.26
2021-03-23,RTGS,0.0,12715.36,101722.9
2021-03-23,Bill,37.25,0.0,101760.15
2021-03-23,Cheque,0.0,101760.15,0.0
2021-03-23,Cheque,56.0,0.0,56.0
2021-03-23,Interest,0.37,0.0,56.37
2021-03-23,NEFT,1687217.0,0.0,1687273.37
2021-03-24,IMPS,0.0,281212.23,1406061.14
2021-03-24,Purchase,71660.3,0.0,1477721.44
2021-03-24,NEFT,0.0,295544.29,1182177.15
2021-03-24,Purchase,0.0,168882.45,1013294.7
2021-03-24,ATM,8377.0,0.0,1021671.7
2021-03-24,Commission,256.44,0.0,1021928.14
2021-03-24,Cheque,182482.0,0.0,1204410.14
2021-03-24,Debit Card,16483.6,0.0,1220893.74
2021-03-24,Commission,28786.0,0.0,1249679.74
2021-03-24,Purchase,98247.06,0.0,1347926.8
2021-03-24,Cash,0.0,1347926.8,0.0
2021-03-24,Debit Card,246.0,0.0,246.0
2021-03-24,Cheque,4.19,0.0,250.19
2021-03-24,Purchase,469.1,0.0,719.29
2021-03-24,Bill,26684.8,0.0,27404.09
2021-03-24,IMPS,0.0,3044.9,24359.19
2021-03-24,Commission,401.4,0.0,24760.59
2021-03-24,Miscellaneous,222577.81,0.0,247338.4
2021-03-24,Transfer,28285.8,0.0,275624.2
2021-03-24,Bill,3842.0,0.0,279466.2
2021-03-24,Tax,3433.41,0.0,282899.61
2021-03-24,Commission,0.0,141449.81,141449.8
2021-03-24,Debit Card,0.0,70724.9,70724.9
2021-03-24,Tax,0.0,70724.9,0.0
2021-03-24,Cheque,3309.8,0.0,3309.8
2021-03-24,Commission,2.4,0.0,3312.2
2021-03-24,Purchase,8271.4,0.0,11583.6
2021-03-24,Cash,16923.47,0.0,28507.07
2021-03-25,NEFT,1636.0,0.0,30143.07
2021-03-25,RTGS,2.28,0.0,30145.35
2021-03-25,Commission,0.0,3768.17,26377.18
2021-03-25,IMPS,0.0,3768.17,22609.01
2021-03-25,Cash,27291.2,0.0,49900.21
2021-03-25,Tax,301.11,0.0,50201.32
2021-03-25,Interest,6.9,0.0,50208.22
2021-03-25,NEFT,221818.5,0.0,272026.72
2021-03-25,Cash,21509.0,0.0,293535.72
2021-03-25,RTGS,0.0,29353.57,264182.15
2021-03-25,Miscellaneous,0.0,29353.57,234828.58
2021-03-25,Tax,0.0,39138.1,195690.48
2021-03-25,Miscellaneous,0.0,65230.16,130460.32
2021-03-26,Debit Card,213330.0,0.0,343790.32
2021-03-26,RTGS,289.8,0.0,344080.12
2021-03-26,ATM,268.46,0.0,344348.58
2021-03-26,Interest,0.0,86087.15,258261.44
2021-03-26,Debit Card,0.0,28695.72,229565.72
2021-03-26,Debit Card,0.0,22956.57,206609.15
2021-03-26,ATM,0.0,29515.59,177093.56
2021-03-26,Cheque,1530.0,0.0,178623.56
2021-03-26,ATM,1369.0,0.0,179992.56
2021-03-26,Transfer,4.11,0.0,179996.67
2021-03-26,Cash,112.1,0.0,180108.77
2021-03-26,IMPS,0.0,45027.19,135081.58
2021-03-26,Cheque,1871105.5,0.0,2006187.08
2021-03-26,Debit Card,0.0,222909.68,1783277.4
2021-03-26,Miscellaneous,0.0,445819.35,1337458.05
2021-03-26,RTGS,0.0,167182.26,1170275.79
2021-03-26,Miscellaneous,0.0,146284.47,1023991.32
2021-03-26,Interest,0.7,0.0,1023992.02
2021-03-26,IMPS,0.0,113776.89,910215.13
2021-03-26,Purchase,0.0,101135.01,809080.12
2021-03-26,Transfer,194.88,0.0,809275.0
2021-03-26,Cheque,2087.8,0.0,811362.8
2021-03-26,Commission,899.0,0.0,812261.8
2021-03-26,Transfer,10291.6,0.0,822553.4
2021-03-26,Commission,0.0,82255.34,740298.06
2021-03-26,RTGS,0.0,74029.81,666268.25
2021-03-26,Commission,18978.69,0.0,685246.94
2021-03-26,Interest,0.0,171311.74,513935.2
2021-03-26,Miscellaneous,6.2,0.0,513941.4
2021-03-26,ATM,487869.0,0.0,1001810.4
2021-03-26,IMPS,0.0,100181.04,901629.36
2021-03-26,Reversal,0.0,901629.36,0.0
2021-03-26,RTGS,253917.06,0.0,253917.06
2021-03-26,Transfer,0.0,25391.71,228525.35
2021-03-26,Interest,0.0,25391.71,203133.64
2021-03-26,Interest,38.26,0.0,203171.9
2021-03-26,IMPS,406.7,0.0,203578.6
2021-03-26,ATM,0.0,33929.77,169648.83
2021-03-26,Transfer,0.0,24235.55,145413.28
2021-03-26,IMPS,1015.5,0.0,146428.78
2021-03-26,Reversal,0.0,48809.59,97619.19
2021-03-26,Bill,0.0,48809.6,48809.6
2021-03-26,IMPS,2.2,0.0,48811.8
2021-03-26,Purchase,968964.0,0.0,1017775.8
2021-03-26,Purchase,220.5,0.0,1017996.3
2021-03-26,Reversal,515.0,0.0,1018511.3
2021-03-26,Tax,4.52,0.0,1018515.82
2021-03-26,Cheque,0.0,169752.64,848763.18
2021-03-26,Debit Card,9792.32,0.0,858555.5
2021-03-26,Commission,536.5,0.0,859092.0
2021-03-26,Debit Card,0.0,95454.67,763637.33
2021-03-26,RTGS,0.0,381818.67,381818.66
2021-03-26,RTGS,238701.94,0.0,620520.6
2021-03-26,ATM,0.0,620520.6,0.0
2021-03-26,Purchase,8984.9,0.0,8984.9
2021-03-26,Transfer,0.0,1123.11,7861.79
2021-03-26,Interest,0.0,7861.79,0.0
2021-03-26,Debit Card,812018.0,0.0,812018.0
2021-03-26,Reversal,0.0,116002.57,696015.43
2021-03-26,Transfer,10.0,0.0,696025.43
2021-03-26,Cheque,0.0,87003.18,609022.25
2021-03-26,Bill,159850.7,0.0,768872.95
2021-03-26,Reversal,146894.0,0.0,915766.95
2021-03-26,NEFT,0.0,91576.7,824190.26
2021-03-26,NEFT,0.0,137365.04,686825.22
2021-03-26,Tax,6.72,0.0,686831.94
2021-03-26,Purchase,39327.2,0.0,726159.14
2021-03-26,Reversal,0.0,363079.57,363079.57
2021-03-26,Interest,2346.6,0.0,365426.17
2021-03-26,Bill,67903.41,0.0,433329.58
2021-03-26,IMPS,978213.0,0.0,1411542.58
2021-03-26,NEFT,0.0,282308.52,1129234.06
2021-03-26,Tax,16.9,0.0,1129250.96
2021-03-26,Bill,0.0,161321.57,967929.39
2021-03-26,NEFT,0.0,967929.39,0.0
2021-03-26,Cheque,0.5,0.0,0.5
2021-03-26,Transfer,0.0,0.1,0.4
2021-03-26,Transfer,398.7,0.0,399.1
2021-03-27,Interest,0.0,133.03,266.07
2021-03-27,Purchase,0.0,29.56,236.51
2021-03-27,Debit Card,5.47,0.0,241.98
2021-03-27,IMPS,541.82,0.0,783.8
2021-03-27,Bill,0.0,391.9,391.9
2021-03-27,Miscellaneous,0.0,195.95,195.95
2021-03-27,Bill,0.0,27.99,167.96
2021-03-27,Transfer,739.39,0.0,907.35
2021-03-27,ATM,146882.12,0.0,147789.47
2021-03-27,Cheque,0.0,14778.95,133010.52
2021-03-27,Debit Card,0.0,16626.32,116384.2
2021-03-27,Bill,260881.0,0.0,377265.2
2021-03-28,NEFT,6.17,0.0,377271.37
2021-03-28,Miscellaneous,0.0,47158.92,330112.45
2021-03-28,Bill,271.27,0.0,330383.72
2021-03-28,Commission,0.0,41297.97,289085.76
2021-03-28,Debit Card,22024.88,0.0,311110.64
2021-03-28,Transfer,0.0,34567.85,276542.79
2021-03-28,ATM,27.25,0.0,276570.04
2021-03-28,IMPS,212976.2,0.0,489546.24
2021-03-28,NEFT,0.0,163182.08,326364.16
2021-03-28,Commission,5.53,0.0,326369.69
2021-03-28,NEFT,0.0,32636.97,293732.72
2021-03-28,Transfer,0.0,29373.27,264359.45
2021-03-28,Cheque,0.0,29373.27,234986.18
2021-03-28,Bill,0.0,29373.27,205612.91
2021-03-29,Cash,0.0,68537.64,137075.27
2021-03-29,Interest,301.0,0.0,137376.27
2021-03-29,Reversal,921.89,0.0,138298.16
2021-03-29,Tax,0.0,15366.46,122931.7
2021-03-29,ATM,383.0,0.0,123314.7
2021-03-29,RTGS,0.0,20552.45,102762.25
2021-03-29,Reversal,9825.0,0.0,112587.25
2021-03-29,Tax,0.0,22517.45,90069.8
2021-03-29,Interest,5.27,0.0,90075.07
2021-03-30,NEFT,0.0,10008.34,80066.73
2021-03-30,Cash,0.0,11438.1,68628.63
2021-03-30,Bill,0.0,13725.73,54902.9
2021-03-30,Debit Card,0.0,18300.97,36601.93
2021-03-31,ATM,0.0,6100.32,30501.61
2021-03-31,Bill,0.0,3389.07,27112.54
2021-04-01,Transfer,0.0,4518.76,22593.78
2021-04-01,Commission,0.0,3227.68,19366.1
2021-04-02,Bill,0.0,3873.22,15492.88
2021-04-03,Interest,1529652.0,0.0,1545144.88
2021-04-03,NEFT,30583.0,0.0,1575727.88
2021-04-03,Debit Card,0.0,157572.79,1418155.09
2021-04-03,Bill,0.0,354538.77,1063616.32
2021-04-03,Interest,2.0,0.0,1063618.32
2021-04-03,Interest,21.0,0.0,1063639.32
2021-04-03,Debit Card,1.82,0.0,1063641.14
2021-04-03,Tax,0.0,212728.23,850912.91
2021-04-03,Commission,0.0,94545.88,756367.03
2021-04-03,Cash,63.8,0.0,756430.83
2021-04-03,Purchase,35.7,0.0,756466.53
2021-04-03,ATM,8932.68,0.0,765399.21
2021-04-03,Commission,0.0,109342.74,656056.47
2021-04-04,ATM,252327.0,0.0,908383.47
2021-04-04,Interest,0.0,100931.5,807451.97
2021-04-04,Interest,0.0,89716.89,717735.08
2021-04-04,Reversal,164500.0,0.0,882235.08
2021-04-04,Transfer,0.0,147039.18,735195.9
2021-04-04,Reversal,0.0,735195.9,0.0
2021-04-04,Commission,5817.0,0.0,5817.0
2021-04-04,Interest,2.9,0.0,5819.9
2021-04-04,ATM,0.0,5819.9,0.0
2021-04-04,Tax,62.0,0.0,62.0
2021-04-04,ATM,2330.53,0.0,2392.53
2021-04-04,IMPS,13218.75,0.0,15611.28
2021-04-04,IMPS,0.0,1561.13,14050.15
2021-04-04,Reversal,1274743.5,0.0,1288793.65
2021-04-04,Purchase,3.73,0.0,1288797.38
2021-04-04,RTGS,27095.0,0.0,1315892.38
2021-04-04,RTGS,0.0,263178.48,1052713.9
2021-04-04,RTGS,37.5,0.0,1052751.4
2021-04-04,Commission,0.0,150393.06,902358.34
2021-04-04,Transfer,551948.0,0.0,1454306.34
2021-04-04,Reversal,0.0,290861.27,1163445.07
2021-04-04,Bill,6.0,0.0,1163451.07
2021-04-04,Interest,724.0,0.0,1164175.07
2021-04-04,Purchase,7.11,0.0,1164182.18
2021-04-04,ATM,0.0,388060.73,776121.45
2021-04-04,Interest,0.0,97015.18,679106.27
2021-04-04,RTGS,39.92,0.0,679146.19
2021-04-04,Reversal,0.0,97020.88,582125.31
2021-04-04,Cash,26391.0,0.0,608516.31
2021-04-04,Cash,0.0,202838.77,405677.54
2021-04-04,Miscellaneous,0.0,405677.54,0.0
2021-04-04,RTGS,1226925.0,0.0,1226925.0
2021-04-04,Commission,0.0,153365.63,1073559.38
2021-04-04,Cash,1698206.5,0.0,2771765.88
2021-04-04,Cash,0.0,2771765.88,0.0
2021-04-04,Cheque,2055544.0,0.0,2055544.0
2021-04-04,Miscellaneous,0.0,2055544.0,0.0
2021-04-04,Interest,226.9,0.0,226.9
2021-04-04,Miscellaneous,0.0,45.38,181.52
2021-04-04,Cheque,13.47,0.0,194.99
2021-04-04,Reversal,4.0,0.0,198.99
2021-04-04,Tax,0.0,49.75,149.24
2021-04-04,Transfer,196.71,0.0,345.95
2021-04-04,Debit Card,0.0,345.95,0.0
2021-04-04,Interest,542570.0,0.0,542570.0
2021-04-04,RTGS,0.0,135642.5,406927.5
2021-04-04,Reversal,20.8,0.0,406948.3
2021-04-04,Bill,2.0,0.0,406950.3
2021-04-04,NEFT,10637.0,0.0,417587.3
2021-04-04,Miscellaneous,673738.5,0.0,1091325.8
2021-04-04,Cheque,0.0,545662.9,545662.9
2021-04-04,Reversal,256228.0,0.0,801890.9
2021-04-04,IMPS,0.0,80189.09,721701.81
2021-04-04,Tax,0.0,90212.73,631489.08
2021-04-04,Transfer,0.0,631489.08,0.0
2021-04-04,ATM,175289.9,0.0,175289.9
2021-04-04,ATM,0.0,43822.48,131467.42
2021-04-04,Commission,191380.1,0.0,322847.52
2021-04-04,Cash,24.6,0.0,322872.12
2021-04-04,Debit Card,0.0,53812.02,269060.1
2021-04-04,RTGS,0.0,29895.57,239164.53
2021-04-04,Purchase,0.0,29895.57,209268.96
2021-04-04,Miscellaneous,32545.0,0.0,241813.96
2021-04-05,Tax,3.0,0.0,241816.96
2021-04-05,Cheque,222509.1,0.0,464326.06
2021-04-05,NEFT,0.0,46432.61,417893.45
2021-04-05,Cash,0.0,417893.45,0.0
2021-04-05,ATM,0.0,0.0,0.0
2021-04-05,Debit Card,56.8,0.0,56.8
2021-04-05,Tax,151842.19,0.0,151898.99
2021-04-05,Purchase,0.0,151898.99,0.0
2021-04-05,Interest,1272251.0,0.0,1272251.0
2021-04-05,Cash,111878.0,0.0,1384129.0
2021-04-05,Purchase,40.39,0.0,1384169.39
2021-04-05,IMPS,23512.0,0.0,1407681.39
2021-04-06,Bill,15659.09,0.0,1423340.48
2021-04-06,Tax,1.9,0.0,1423342.38
2021-04-07,Commission,0.0,355835.6,1067506.78
2021-04-07,Commission,0.0,533753.39,533753.39
2021-04-07,Bill,0.0,533753.39,0.0
2021-04-07,ATM,1882484.8,0.0,1882484.8
2021-04-07,Reversal,0.0,313747.47,1568737.33
2021-04-07,Transfer,1850090.25,0.0,3418827.58
2021-04-07,Transfer,230.87,0.0,3419058.45
2021-04-07,RTGS,0.0,854764.61,2564293.84
2021-04-07,Cheque,0.0,427382.31,2136911.53
2021-04-07,Cheque,0.0,356151.92,1780759.61
2021-04-07,Purchase,0.0,445189.9,1335569.71
2021-04-07,Purchase,10997.0,0.0,1346566.71
2021-04-07,Cheque,59.51,0.0,1346626.22
2021-04-07,IMPS,125258.03,0.0,1471884.25
2021-04-07,Cash,0.0,735942.13,735942.12
2021-04-07,Cash,246017.72,0.0,981959.84
2021-04-07,Tax,1801171.5,0.0,2783131.34
2021-04-07,Transfer,445.0,0.0,2783576.34
2021-04-07,ATM,0.0,397653.76,2385922.58
2021-04-07,Commission,33.2,0.0,2385955.78
2021-04-07,Cheque,1.49,0.0,2385957.27
2021-04-07,Purchase,5.1,0.0,2385962.37
2021-04-07,Transfer,17565.0,0.0,2403527.37
2021-04-07,Cash,0.0,240352.74,2163174.63
2021-04-07,NEFT,0.0,540793.66,1622380.97
2021-04-07,IMPS,1589017.0,0.0,3211397.97
2021-04-07,RTGS,77810.4,0.0,3289208.37
2021-04-07,Bill,5.28,0.0,3289213.65
2021-04-07,Miscellaneous,1925.0,0.0,3291138.65
2021-04-07,Transfer,0.0,411392.33,2879746.32
2021-04-07,Cash,94.81,0.0,2879841.13
2021-04-07,Commission,0.0,479973.52,2399867.61
2021-04-08,Purchase,7086.0,0.0,2406953.61
2021-04-08,Debit Card,1078.37,0.0,2408031.98
2021-04-08,Cash,0.0,301004.0,2107027.98
2021-04-08,Miscellaneous,0.0,210702.8,1896325.18
2021-04-08,Debit Card,32911.31,0.0,1929236.49
2021-04-08,Purchase,29.93,0.0,1929266.42
2021-04-08,ATM,3341.29,0.0,1932607.71
2021-04-08,Cheque,18.5,0.0,1932626.21
2021-04-08,Bill,0.0,193262.62,1739363.59
2021-04-08,Commission,0.0,248480.51,1490883.08
2021-04-08,IMPS,0.0,186360.39,1304522.7
2021-04-08,Commission,32533.29,0.0,1337055.99
2021-04-08,IMPS,0.0,1337055.99,0.0
2021-04-08,Miscellaneous,21444.0,0.0,21444.0
2021-04-08,Cash,86977.25,0.0,108421.25
2021-04-08,Miscellaneous,6.1,0.0,108427.35
2021-04-08,Tax,15.7,0.0,108443.05
2021-04-08,Commission,110321.41,0.0,218764.46
2021-04-08,Reversal,211.0,0.0,218975.46
2021-04-08,Interest,0.0,109487.73,109487.73
2021-04-08,Cash,0.0,13685.97,95801.76
2021-04-08,Purchase,233.0,0.0,96034.76
2021-04-08,NEFT,122.5,0.0,96157.26
2021-04-08,RTGS,0.0,9615.73,86541.53
2021-04-08,IMPS,0.0,43270.77,43270.76
2021-04-08,Cheque,90774.16,0.0,134044.92
2021-04-08,Miscellaneous,0.0,134044.92,0.0
2021-04-08,ATM,30433.0,0.0,30433.0
2021-04-08,Tax,5.2,0.0,30438.2
2021-04-08,Interest,0.0,10146.07,20292.13
2021-04-08,IMPS,0.0,4058.43,16233.7
2021-04-08,Miscellaneous,0.0,16233.7,0.0
2021-04-08,Cash,3228.42,0.0,3228.42
2021-04-09,Tax,0.0,645.68,2582.74
2021-04-09,Bill,0.0,1291.37,1291.37
2021-04-09,ATM,0.0,430.46,860.91
2021-04-09,IMPS,0.0,122.99,737.92
2021-04-09,NEFT,0.0,105.42,632.5
2021-04-09,ATM,4926.0,0.0,5558.5
2021-04-09,Commission,0.0,926.42,4632.08
2021-04-10,Miscellaneous,0.0,579.01,4053.07
2021-04-10,Commission,0.0,405.31,3647.76
2021-04-11,ATM,1098583.0,0.0,1102230.76
2021-04-11,Reversal,0.0,1102230.76,0.0
2021-04-11,ATM,256053.1,0.0,256053.1
2021-04-11,Transfer,2719.75,0.0,258772.85
2021-04-11,Miscellaneous,0.0,32346.61,226426.24
2021-04-11,Reversal,2985.0,0.0,229411.24
2021-04-11,ATM,1447556.0,0.0,1676967.24
2021-04-11,ATM,0.0,419241.81,1257725.43
2021-04-11,Cash,1.9,0.0,1257727.33
2021-04-11,Bill,3247.8,0.0,1260975.13
2021-04-11,ATM,222815.81,0.0,1483790.94
2021-04-11,ATM,76204.78,0.0,1559995.72
2021-04-11,Interest,57.0,0.0,1560052.72
2021-04-11,Debit Card,0.0,222864.67,1337188.05
2021-04-11,Tax,2593.55,0.0,1339781.6
2021-04-11,Bill,0.0,223296.93,1116484.67
2021-04-11,Miscellaneous,35.78,0.0,1116520.45
2021-04-11,Miscellaneous,503.78,0.0,1117024.23
2021-04-11,RTGS,0.0,111702.42,1005321.81
2021-04-11,IMPS,61.8,0.0,1005383.61
2021-04-11,Debit Card,0.0,167563.94,837819.68
2021-04-11,Commission,14063.15,0.0,851882.83
2021-04-11,NEFT,3255.0,0.0,855137.83
2021-04-11,Cheque,0.0,171027.57,684110.26
2021-04-11,Cheque,0.0,684110.26,0.0
2021-04-11,Reversal,120184.0,0.0,120184.0
2021-04-11,IMPS,2.8,0.0,120186.8
2021-04-11,Transfer,682162.2,0.0,802349.0
2021-04-11,Interest,0.0,89149.89,713199.11
2021-04-11,RTGS,0.0,79244.35,633954.76
2021-04-11,Miscellaneous,0.0,90564.97,543389.79
2021-04-11,Transfer,0.0,181129.93,362259.86
2021-04-11,Transfer,0.0,72451.97,289807.89
2021-04-11,RTGS,609666.75,0.0,899474.64
2021-04-11,Bill,165.9,0.0,899640.54
2021-04-11,NEFT,16.0,0.0,899656.54
2021-04-11,Tax,658.0,0.0,900314.54
2021-04-11,Reversal,0.0,128616.36,771698.18
2021-04-11,Transfer,0.0,77169.82,694528.36
2021-04-11,Reversal,1164987.25,0.0,1859515.61
2021-04-11,RTGS,0.0,185951.56,1673564.05
2021-04-11,ATM,0.0,185951.56,1487612.49
2021-04-11,Debit Card,485.0,0.0,1488097.49
2021-04-11,NEFT,1879550.2,0.0,3367647.69
2021-04-12,Debit Card,64566.0,0.0,3432213.69
2021-04-12,Transfer,0.0,429026.71,3003186.98
2021-04-12,Transfer,0.0,429026.71,2574160.27
2021-04-12,Bill,3807.52,0.0,2577967.79
2021-04-12,ATM,40.0,0.0,2578007.79
2021-04-12,Bill,0.0,429667.97,2148339.83
2021-04-12,Cheque,0.0,2148339.83,0.0
2021-04-12,Cash,165388.53,0.0,165388.53
2021-04-12,Purchase,0.0,16538.85,148849.68
2021-04-12,ATM,216.0,0.0,149065.68
2021-04-12,Interest,0.0,14906.57,134159.11
2021-04-12,Debit Card,30606.0,0.0,164765.11
2021-04-12,RTGS,5939.27,0.0,170704.38
2021-04-12,Bill,13959.0,0.0,184663.38
2021-04-12,Reversal,0.0,18466.34,166197.04
2021-04-12,Purchase,25513.3,0.0,191710.34
2021-04-12,Tax,0.0,31951.72,159758.62
2021-04-12,Reversal,0.78,0.0,159759.4
2021-04-12,NEFT,0.0,31951.88,127807.52
2021-04-12,Transfer,0.0,42602.51,85205.01
2021-04-12,RTGS,0.0,21301.25,63903.76
2021-04-13,IMPS,113075.3,0.0,176979.06
2021-04-13,ATM,0.0,19664.34,157314.72
2021-04-13,Cash,746.34,0.0,158061.06
2021-04-13,RTGS,0.0,39515.27,118545.8
2021-04-13,Commission,0.0,39515.27,79030.53
2021-04-13,Reversal,49.0,0.0,79079.53
2021-04-13,Bill,40.8,0.0,79120.33
2021-04-14,Reversal,0.0,39560.17,39560.16
2021-04-14,NEFT,0.0,3956.02,35604.14
2021-04-14,Miscellaneous,0.0,11868.05,23736.09
2021-04-14,Cash,91.3,0.0,23827.39
2021-04-14,ATM,0.0,23827.39,0.0
2021-04-14,Transfer,4063.81,0.0,4063.81
2021-04-14,Cheque,29639.15,0.0,33702.96
2021-04-14,Commission,6.4,0.0,33709.36
2021-04-14,Purchase,4083.5,0.0,37792.86
2021-04-14,Reversal,3.62,0.0,37796.48
2021-04-14,NEFT,24046.1,0.0,61842.58
2021-04-14,Reversal,139.94,0.0,61982.52
2021-04-14,IMPS,0.0,10330.42,51652.1
2021-04-14,Commission,26007.9,0.0,77660.0
2021-04-14,Tax,233695.5,0.0,311355.5
2021-04-14,Tax,0.0,38919.44,272436.06
2021-04-14,Bill,0.0,68109.02,204327.04
2021-04-14,ATM,1818604.8,0.0,2022931.84
2021-04-14,Tax,0.0,2022931.84,0.0
2021-04-14,Purchase,6.0,0.0,6.0
2021-04-14,Bill,0.0,3.0,3.0
2021-04-14,Bill,2955.2,0.0,2958.2
2021-04-14,Tax,55.1,0.0,3013.3
2021-04-14,Purchase,207209.0,0.0,210222.3
2021-04-14,IMPS,3684.0,0.0,213906.3
2021-04-14,NEFT,0.0,71302.1,142604.2
2021-04-14,Tax,0.0,28520.84,114083.36
2021-04-14,IMPS,0.0,57041.68,57041.68
2021-04-14,Miscellaneous,165.0,0.0,57206.68
2021-04-14,NEFT,0.0,8172.38,49034.3
2021-04-14,RTGS,0.0,5448.26,43586.04
2021-04-14,Cheque,203.0,0.0,43789.04
2021-04-14,Cash,0.0,4865.45,38923.59
2021-04-14,Purchase,7.0,0.0,38930.59
2021-04-14,IMPS,241158.5,0.0,280089.09
2021-04-14,RTGS,214.4,0.0,280303.49
2021-04-14,Tax,0.0,280303.49,0.0
2021-04-14,Commission,1631.5,0.0,1631.5
2021-04-14,Purchase,0.0,815.75,815.75
2021-04-14,Miscellaneous,0.0,203.94,611.81
2021-04-14,Bill,0.0,122.36,489.45
2021-04-14,Purchase,0.0,122.36,367.09
2021-04-14,Commission,0.0,45.89,321.2
2021-04-15,IMPS,219058.5,0.0,219379.7
2021-04-15,ATM,136150.0,0.0,355529.7
2021-04-15,Cash,0.0,118509.9,237019.8
2021-04-15,Interest,0.0,23701.98,213317.82
2021-04-15,IMPS,0.0,30473.97,182843.85
2021-04-15,Debit Card,77.3,0.0,182921.15
2021-04-15,IMPS,17432.1,0.0,200353.25
2021-04-15,Cash,0.0,66784.42,133568.83
2021-04-15,Commission,319.0,0.0,133887.83
2021-04-15,IMPS,123.17,0.0,134011.0
2021-04-15,Bill,0.0,16751.38,117259.62
2021-04-15,Transfer,1357261.5,0.0,1474521.12
2021-04-15,Purchase,0.0,245753.52,1228767.6
2021-04-15,IMPS,0.0,136529.73,1092237.87
2021-04-15,Miscellaneous,0.0,218447.57,873790.3
2021-04-15,Miscellaneous,0.0,124827.19,748963.11
2021-04-15,Bill,0.0,748963.11,0.0
2021-04-15,Miscellaneous,4092.0,0.0,4092.0
2021-04-15,Debit Card,0.0,818.4,3273.6
2021-04-15,Tax,17788.4,0.0,21062.0
2021-04-15,Cheque,0.0,3510.33,17551.67
2021-04-15,Interest,4.7,0.0,17556.37
2021-04-15,Interest,0.0,3511.27,14045.1
2021-04-15,ATM,2.7,0.0,14047.8
2021-04-15,Debit Card,53.0,0.0,14100.8
2021-04-15,IMPS,0.0,14100.8,0.0
2021-04-15,Debit Card,1495.0,0.0,1495.0
2021-04-15,IMPS,5377.9,0.0,6872.9
2021-04-15,Reversal,0.0,1145.48,5727.42
2021-04-15,NEFT,160084.0,0.0,165811.42
2021-04-15,Cash,0.0,165811.42,0.0
2021-04-15,Cash,466.0,0.0,466.0
2021-04-15,Tax,0.0,51.78,414.22
2021-04-15,Transfer,95.42,0.0,509.64
2021-04-15,Interest,0.0,72.81,436.83
2021-04-15,Interest,0.0,218.42,218.42
2021-04-15,Reversal,0.0,54.61,163.82
2021-04-15,Miscellaneous,0.0,32.76,131.06
2021-04-15,Commission,0.0,65.53,65.53
2021-04-15,Transfer,457354.0,0.0,457419.53
2021-04-15,Cheque,206178.0,0.0,663597.53
2021-04-15,Tax,0.0,82949.69,580647.84
2021-04-15,RTGS,3450.3,0.0,584098.14
2021-04-15,Reversal,0.0,97349.69,486748.45
2021-04-15,Purchase,0.0,162249.48,324498.97
2021-04-15,NEFT,8.0,0.0,324506.97
2021-04-15,Cheque,6.56,0.0,324513.53
2021-04-15,Bill,1519.7,0.0,326033.23
2021-04-15,Debit Card,0.0,65206.65,260826.58
2021-04-15,ATM,254435.0,0.0,515261.58
2021-04-15,Debit Card,0.0,85876.93,429384.65
2021-04-15,Debit Card,0.0,429384.65,0.0
2021-04-15,Cash,30996.43,0.0,30996.43
2021-04-15,Tax,0.0,15498.22,15498.22
2021-04-15,Tax,22.0,0.0,15520.22
2021-04-15,Debit Card,371.2,0.0,15891.42
2021-04-15,Debit Card,0.0,15891.42,0.0
2021-04-15,Transfer,1389840.0,0.0,1389840.0
2021-04-15,Interest,396.3,0.0,1390236.3
2021-04-16,Cheque,5.3,0.0,1390241.6
2021-04-16,ATM,7112.16,0.0,1397353.76
2021-04-16,Debit Card,183.53,0.0,1397537.29
2021-04-16,Debit Card,154.56,0.0,1397691.85
2021-04-16,Commission,0.0,155299.09,1242392.76
2021-04-16,Bill,28587.1,0.0,1270979.86
2021-04-16,Cash,1458566.0,0.0,2729545.86
2021-04-16,Purchase,0.0,389935.12,2339610.74
2021-04-16,IMPS,2440.0,0.0,2342050.74
2021-04-16,Debit Card,35.39,0.0,2342086.13
2021-04-16,Interest,1520.77,0.0,2343606.9
2021-04-16,IMPS,0.0,390601.15,1953005.75
2021-04-16,Cheque,5.66,0.0,1953011.41
2021-04-16,Cheque,0.0,279001.63,1674009.78
2021-04-16,NEFT,0.0,558003.26,1116006.52
2021-04-16,Transfer,197625.0,0.0,1313631.52
2021-04-16,Debit Card,0.0,328407.88,985223.64
2021-04-16,RTGS,402.0,0.0,985625.64
2021-04-16,Commission,0.0,985625.64,0.0
2021-04-16,Purchase,6.73,0.0,6.73
2021-04-16,RTGS,9743.0,0.0,9749.73
2021-04-16,Bill,13.7,0.0,9763.43
2021-04-16,RTGS,6.0,0.0,9769.43
2021-04-16,Transfer,0.0,1395.63,8373.8
2021-04-16,Tax,0.0,1196.26,7177.54
2021-04-16,Interest,0.0,2392.51,4785.03
2021-04-16,Transfer,0.0,1196.26,3588.77
2021-04-17,Cheque,0.0,897.19,2691.58
2021-04-17,Transfer,0.0,2691.58,0.0
2021-04-17,IMPS,1534198.0,0.0,1534198.0
2021-04-17,NEFT,3143.0,0.0,1537341.0
2021-04-17,Cash,787539.8,0.0,2324880.8
2021-04-18,Purchase,13501.0,0.0,2338381.8
2021-04-18,Commission,21807.0,0.0,2360188.8
2021-04-18,Cheque,3.2,0.0,2360192.0
2021-04-18,RTGS,0.0,262243.56,2097948.44
2021-04-18,Commission,0.0,419589.69,1678358.75
2021-04-18,Commission,151467.5,0.0,1829826.25
2021-04-18,ATM,1402.0,0.0,1831228.25
2021-04-18,Bill,41.65,0.0,1831269.9
2021-04-18,RTGS,0.0,183126.99,1648142.91
2021-04-18,Commission,356.75,0.0,1648499.66
2021-04-18,ATM,0.0,274749.94,1373749.72
2021-04-18,Interest,188.5,0.0,1373938.22
2021-04-18,IMPS,0.0,274787.64,1099150.58
2021-04-18,Bill,0.0,274787.65,824362.94
2021-04-18,Miscellaneous,38.3,0.0,824401.24
2021-04-18,Transfer,0.0,274800.41,549600.83
2021-04-18,Purchase,47.22,0.0,549648.05
2021-04-18,Miscellaneous,0.0,68706.01,480942.04
2021-04-18,Commission,1605695.0,0.0,2086637.04
2021-04-18,Transfer,0.0,2086637.04,0.0
2021-04-18,NEFT,12.0,0.0,12.0
2021-04-18,Interest,0.0,12.0,0.0
2021-04-18,RTGS,487.0,0.0,487.0
2021-04-18,RTGS,0.0,81.17,405.83
2021-04-18,Transfer,0.0,81.17,324.66
2021-04-18,Reversal,0.0,108.22,216.44
2021-04-18,IMPS,0.0,21.64,194.8
2021-04-18,Bill,51915.09,0.0,52109.89
2021-04-18,RTGS,0.0,5210.99,46898.9
2021-04-18,Cash,363.6,0.0,47262.5
2021-04-18,Transfer,0.0,47262.5,0.0
2021-04-18,Miscellaneous,241005.5,0.0,241005.5
2021-04-18,RTGS,0.0,120502.75,120502.75
2021-04-18,Cash,10.76,0.0,120513.51
2021-04-18,Commission,127365.38,0.0,247878.89
2021-04-18,NEFT,0.0,61969.72,185909.17
2021-04-18,Debit Card,0.0,46477.29,139431.88
2021-04-18,Cheque,0.0,17428.99,122002.9
2021-04-18,Cheque,229863.0,0.0,351865.9
2021-04-18,Tax,19757.8,0.0,371623.7
2021-04-18,Tax,0.0,371623.7,0.0
2021-04-18,Bill,2756.5,0.0,2756.5
2021-04-18,ATM,227452.0,0.0,230208.5
2021-04-18,Interest,1751.2,0.0,231959.7
2021-04-18,Interest,0.0,77319.9,154639.8
2021-04-18,Cash,0.0,19329.98,135309.82
2021-04-18,Cash,2187.0,0.0,137496.82
2021-04-18,ATM,15.0,0.0,137511.82
2021-04-18,Interest,0.0,22918.64,114593.18
2021-04-18,Interest,0.0,11459.32,103133.86
2021-04-19,Miscellaneous,0.0,10313.39,92820.47
2021-04-19,NEFT,0.0,18564.09,74256.38
2021-04-19,Commission,209037.1,0.0,283293.48
2021-04-19,IMPS,0.0,35411.69,247881.8
2021-04-19,Miscellaneous,0.0,49576.36,198305.44
2021-04-19,NEFT,3673.5,0.0,201978.94
2021-04-19,Reversal,13061.1,0.0,215040.04
2021-04-19,Purchase,304.49,0.0,215344.53
2021-04-19,Purchase,0.0,30763.5,184581.03
2021-04-19,ATM,0.0,26368.72,158212.31
2021-04-19,IMPS,75960.0,0.0,234172.31
2021-04-19,Debit Card,23241.0,0.0,257413.31
2021-04-19,Miscellaneous,1339.8,0.0,258753.11
2021-04-19,Miscellaneous,5098.1,0.0,263851.21
2021-04-19,Tax,0.0,37693.03,226158.18
2021-04-19,Tax,0.0,75386.06,150772.12
2021-04-20,Transfer,187.1,0.0,150959.22
2021-04-20,Debit Card,0.0,18869.9,132089.32
2021-04-20,Purchase,0.0,33022.33,99066.99
2021-04-20,Debit Card,0.0,49533.5,49533.5
2021-04-20,Reversal,201.03,0.0,49734.53
2021-04-20,RTGS,9353.75,0.0,59088.28
2021-04-20,Reversal,0.0,11817.66,47270.62
2021-04-20,NEFT,0.0,47270.62,0.0
2021-04-20,IMPS,20494.9,0.0,20494.9
2021-04-20,Cheque,15090.0,0.0,35584.9
2021-04-20,Commission,0.0,3953.88,31631.02
2021-04-20,ATM,2358.7,0.0,33989.72
2021-04-20,RTGS,0.0,4248.72,29741.0
2021-04-20,NEFT,0.0,3304.56,26436.44
2021-04-20,Purchase,1673.0,0.0,28109.44
2021-04-20,Tax,750.0,0.0,28859.44
2021-04-20,Miscellaneous,109.0,0.0,28968.44
2021-04-20,Transfer,0.0,2896.84,26071.6
2021-04-20,Commission,0.0,2896.84,23174.76
2021-04-20,Debit Card,8.0,0.0,23182.76
2021-04-20,Tax,62.96,0.0,23245.72
2021-04-20,ATM,0.0,3874.29,19371.43
2021-04-20,Transfer,34131.44,0.0,53502.87
2021-04-20,RTGS,0.0,26751.44,26751.44
2021-04-20,Cash,0.0,13375.72,13375.72
2021-04-20,RTGS,4.0,0.0,13379.72
2021-04-21,Cash,0.0,1672.47,11707.26
2021-04-22,ATM,125527.8,0.0,137235.06
2021-04-22,Commission,0.0,45745.02,91490.04
2021-04-22,NEFT,3417.0,0.0,94907.04
2021-04-22,Commission,0.0,13558.15,81348.89
2021-04-22,RTGS,392.0,0.0,81740.89
2021-04-22,Purchase,50.5,0.0,81791.39
2021-04-22,Miscellaneous,0.0,11684.48,70106.91
2021-04-22,Commission,50365.6,0.0,120472.51
2021-04-22,Commission,0.0,24094.5,96378.01
2021-04-23,NEFT,2494.0,0.0,98872.01
2021-04-23,Interest,0.0,98872.01,0.0
2021-04-23,Interest,651.0,0.0,651.0
2021-04-23,Tax,0.0,0.0,651.0
2021-04-23,RTGS,2517.78,0.0,3168.78
2021-04-23,RTGS,0.0,1056.26,2112.52
2021-04-23,Cash,3887.0,0.0,5999.52
2021-04-24,Interest,262.13,0.0,6261.65
2021-04-24,Commission,67.5,0.0,6329.15
2021-04-24,Cheque,0.0,1054.86,5274.29
2021-04-24,Interest,0.0,2637.15,2637.14
2021-04-24,RTGS,0.0,1318.57,1318.57
2021-04-24,Bill,28.0,0.0,1346.57
2021-04-24,Cheque,0.0,336.64,1009.93
2021-04-24,Miscellaneous,0.0,504.97,504.96
2021-04-24,Commission,0.0,84.16,420.8
2021-04-24,Cash,0.0,140.27,280.53
2021-04-24,Cheque,4820.71,0.0,5101.24
2021-04-24,ATM,0.0,1020.25,4080.99
2021-04-24,RTGS,42.31,0.0,4123.3
2021-04-24,Purchase,0.0,1030.83,3092.48
2021-04-24,Debit Card,11507.0,0.0,14599.48
2021-04-24,NEFT,0.0,7299.74,7299.74
2021-04-24,Cash,0.0,912.47,6387.27
2021-04-24,IMPS,2817.0,0.0,9204.27
2021-04-24,Tax,0.0,1150.53,8053.74
2021-04-24,Interest,228753.19,0.0,236806.93
2021-04-24,Cash,1481.11,0.0,238288.04
2021-04-24,Cheque,2075.0,0.0,240363.04
2021-04-24,Cash,0.0,30045.38,210317.66
2021-04-24,Bill,0.0,30045.38,180272.28
2021-04-24,Commission,125687.5,0.0,305959.78
2021-04-24,Transfer,157.0,0.0,306116.78
2021-04-24,NEFT,14650.9,0.0,320767.68
2021-04-24,Miscellaneous,0.0,40095.96,280671.72
2021-04-24,RTGS,0.0,93557.24,187114.48
2021-04-24,IMPS,0.0,31185.75,155928.73
2021-04-24,Tax,0.0,31185.75,124742.98
2021-04-24,NEFT,86547.3,0.0,211290.28
2021-04-24,Interest,1407.32,0.0,212697.6
2021-04-24,ATM,0.0,70899.2,141798.4
2021-04-24,NEFT,1724223.8,0.0,1866022.2
2021-04-24,Transfer,0.0,311003.7,1555018.5
2021-04-24,Reversal,0.0,259169.75,1295848.75
2021-04-24,Tax,21.4,0.0,1295870.15
2021-04-24,Debit Card,1835.22,0.0,1297705.37
2021-04-24,Cheque,1705.0,0.0,1299410.37
2021-04-24,NEFT,65025.0,0.0,1364435.37
2021-04-24,Miscellaneous,272.08,0.0,1364707.45
2021-04-25,RTGS,271.14,0.0,1364978.59
2021-04-25,ATM,0.0,1364978.59,0.0
2021-04-25,ATM,3417.0,0.0,3417.0
2021-04-25,Interest,0.0,427.13,2989.88
2021-04-25,Cheque,0.0,2989.88,0.0
2021-04-25,Commission,61464.81,0.0,61464.81
2021-04-25,RTGS,0.0,15366.2,46098.61
2021-04-25,IMPS,0.0,15366.2,30732.41
2021-04-25,Reversal,16991.18,0.0,47723.59
2021-04-25,Cheque,0.0,23861.8,23861.8
2021-04-25,Cash,0.0,2651.31,21210.49
2021-04-25,Cash,8782.2,0.0,29992.69
2021-04-25,NEFT,0.0,2999.27,26993.42
2021-04-25,Interest,818844.0,0.0,845837.42
2021-04-26,Commission,3993.0,0.0,849830.42
2021-04-26,Miscellaneous,7.14,0.0,849837.56
2021-04-26,Interest,0.0,84983.76,764853.8
2021-04-26,Cash,3.0,0.0,764856.8
2021-04-26,Cash,17502.0,0.0,782358.8
2021-04-26,Tax,0.0,260786.27,521572.53
2021-04-26,RTGS,29531.1,0.0,551103.63
2021-04-27,ATM,0.0,68887.95,482215.68
2021-04-27,Cheque,1721146.0,0.0,2203361.68
2021-04-27,RTGS,0.0,2203361.68,0.0
2021-04-27,Bill,198.65,0.0,198.65
2021-04-27,ATM,3.0,0.0,201.65
2021-04-27,Bill,0.0,67.22,134.43
2021-04-27,Miscellaneous,0.0,19.2,115.23
2021-04-27,Miscellaneous,0.0,11.52,103.71
2021-04-27,Reversal,812488.5,0.0,812592.21
2021-04-27,Debit Card,0.0,101574.03,711018.18
2021-04-27,Reversal,1.0,0.0,711019.18
2021-04-27,NEFT,0.0,142203.84,568815.34
2021-04-27,Commission,2795.3,0.0,571610.64
2021-04-27,Purchase,0.0,114322.13,457288.51
2021-04-27,Reversal,0.0,114322.13,342966.38
2021-04-27,Transfer,936145.0,0.0,1279111.38
2021-04-27,Interest,5.5,0.0,1279116.88
2021-04-28,Debit Card,0.0,127911.69,1151205.19
2021-04-28,RTGS,3477.0,0.0,1154682.19
2021-04-28,Bill,0.0,1154682.19,0.0
2021-04-29,Tax,179001.5,0.0,179001.5
2021-04-30,Cheque,0.0,19889.06,159112.44
2021-04-30,ATM,3372.69,0.0,162485.13
2021-04-30,NEFT,3950.8,0.0,166435.93
2021-04-30,Miscellaneous,0.0,55478.64,110957.29
2021-04-30,Tax,1422572.25,0.0,1533529.54
2021-04-30,Tax,0.9,0.0,1533530.44
2021-04-30,Transfer,1676.5,0.0,1535206.94
2021-04-30,Interest,0.0,191900.87,1343306.07
2021-04-30,NEFT,5.0,0.0,1343311.07
2021-04-30,ATM,0.0,268662.21,1074648.86
2021-04-30,Bill,21.0,0.0,1074669.86
2021-04-30,Reversal,1944906.5,0.0,3019576.36
2021-04-30,Cash,0.0,431368.05,2588208.31
2021-04-30,NEFT,0.0,2588208.31,0.0
2021-04-30,Miscellaneous,694.0,0.0,694.0
2021-04-30,Miscellaneous,0.0,231.33,462.67
2021-04-30,Cash,0.0,51.41,411.26
2021-04-30,Cheque,0.0,205.63,205.63
2021-05-01,NEFT,0.0,29.38,176.25
2021-05-01,Debit Card,0.0,19.58,156.67
2021-05-01,Debit Card,220839.03,0.0,220995.7
2021-05-01,Debit Card,2.0,0.0,220997.7
2021-05-01,Debit Card,0.0,36832.95,184164.75
2021-05-01,Bill,0.0,92082.38,92082.38
2021-05-01,Debit Card,0.0,30694.13,61388.25
2021-05-01,Purchase,6.8,0.0,61395.05
2021-05-01,Purchase,0.0,30697.53,30697.52
2021-05-01,Commission,0.0,10232.51,20465.01
2021-05-01,NEFT,1074.6,0.0,21539.61
2021-05-01,Bill,0.0,10769.81,10769.8
2021-05-01,Tax,0.0,1076.98,9692.82
2021-05-01,NEFT,287.9,0.0,9980.72
2021-05-01,ATM,0.0,2495.18,7485.54
2021-05-01,IMPS,0.0,748.55,6736.99
2021-05-01,Debit Card,250.6,0.0,6987.59
2021-05-01,Miscellaneous,0.0,698.76,6288.83
2021-05-01,Debit Card,2.72,0.0,6291.55
2021-05-01,Cheque,371.52,0.0,6663.07
2021-05-01,Interest,29.5,0.0,6692.57
2021-05-01,Interest,0.0,956.08,5736.49
2021-05-01,Commission,0.0,1912.16,3824.33
2021-05-01,Tax,57.0,0.0,3881.33
2021-05-01,Reversal,15723.8,0.0,19605.13
2021-05-01,Transfer,0.0,2800.73,16804.4
2021-05-01,Cash,1492074.2,0.0,1508878.6
2021-05-01,IMPS,482108.0,0.0,1990986.6
2021-05-01,Miscellaneous,0.0,398197.32,1592789.28
2021-05-01,Cheque,62.18,0.0,1592851.46
2021-05-01,Cheque,0.0,530950.49,1061900.97
2021-05-01,Reversal,34.29,0.0,1061935.26
2021-05-01,Reversal,95.9,0.0,1062031.16
2021-05-02,Bill,30.6,0.0,1062061.76
2021-05-02,Debit Card,16.9,0.0,1062078.66
2021-05-02,IMPS,0.0,1062078.66,0.0
2021-05-02,Miscellaneous,185138.0,0.0,185138.0
2021-05-02,RTGS,0.0,92569.0,92569.0
2021-05-02,Commission,468.0,0.0,93037.0
2021-05-02,Purchase,0.0,9303.7,83733.3
2021-05-02,Bill,0.0,8373.33,75359.97
2021-05-02,Interest,0.0,8373.33,66986.64
2021-05-02,RTGS,0.0,33493.32,33493.32
2021-05-02,IMPS,0.0,3721.48,29771.84
2021-05-02,Interest,462.54,0.0,30234.38
2021-05-02,Bill,600553.5,0.0,630787.88
2021-05-02,Bill,1857689.25,0.0,2488477.13
2021-05-02,RTGS,0.0,622119.28,1866357.85
2021-05-02,Tax,78777.0,0.0,1945134.85
2021-05-02,Purchase,0.0,648378.28,1296756.57
2021-05-02,Reversal,185923.5,0.0,1482680.07
2021-05-02,Commission,1941.6,0.0,1484621.67
2021-05-02,Interest,3649.6,0.0,1488271.27
2021-05-02,ATM,0.0,248045.21,1240226.06
2021-05-02,Interest,0.0,413408.69,826817.37
2021-05-02,Reversal,0.0,275605.79,551211.58
2021-05-03,Miscellaneous,0.0,275605.79,275605.79
2021-05-03,Cash,0.0,39372.26,236233.53
2021-05-03,Transfer,5.0,0.0,236238.53
2021-05-03,RTGS,12.3,0.0,236250.83
2021-05-03,IMPS,0.0,47250.17,189000.66
2021-05-03,NEFT,0.0,47250.17,141750.5
2021-05-03,Cash,97.0,0.0,141847.5
2021-05-03,Cheque,5.0,0.0,141852.5
2021-05-03,Purchase,1731.0,0.0,143583.5
2021-05-03,Cheque,49.0,0.0,143632.5
2021-05-03,Reversal,0.0,17954.06,125678.44
2021-05-03,IMPS,805770.0,0.0,931448.44
2021-05-03,NEFT,159444.72,0.0,1090893.16
2021-05-03,Debit Card,0.0,181815.53,909077.63
2021-05-03,ATM,19.0,0.0,909096.63
2021-05-03,Bill,0.0,227274.16,681822.47
2021-05-03,Reversal,151779.1,0.0,833601.57
2021-05-03,IMPS,0.0,83360.16,750241.41
2021-05-03,Bill,72649.8,0.0,822891.21
2021-05-04,Purchase,23510.0,0.0,846401.21
2021-05-04,Tax,1.6,0.0,846402.81
2021-05-04,Cash,0.0,846402.81,0.0
2021-05-04,Transfer,2.42,0.0,2.42
2021-05-04,Cash,0.0,0.3,2.12
2021-05-04,Bill,0.0,1.06,1.06
2021-05-04,RTGS,229888.0,0.0,229889.06
2021-05-04,Tax,17586.82,0.0,247475.88
2021-05-04,Tax,451.0,0.0,247926.88
2021-05-04,Tax,3.6,0.0,247930.48
2021-05-04,Commission,0.0,247930.48,0.0
2021-05-04,Commission,14.0,0.0,14.0
2021-05-04,Bill,0.0,2.8,11.2
2021-05-04,Purchase,0.0,1.12,10.08
2021-05-04,Reversal,0.0,1.44,8.64
2021-05-04,Commission,755.0,0.0,763.64
2021-05-04,RTGS,2990.5,0.0,3754.14
2021-05-04,Reversal,1730231.75,0.0,1733985.89
2021-05-04,IMPS,0.8,0.0,1733986.69
2021-05-04,Transfer,0.0,433496.67,1300490.02
2021-05-04,Cash,205015.0,0.0,1505505.02
2021-05-04,Miscellaneous,0.0,1505505.02,0.0
2021-05-04,ATM,112869.06,0.0,112869.06
2021-05-04,Miscellaneous,27936.0,0.0,140805.06
2021-05-04,Commission,0.0,14080.51,126724.55
2021-05-04,Transfer,0.0,126724.55,0.0
2021-05-04,Cash,470.75,0.0,470.75
2021-05-04,Debit Card,0.0,235.38,235.38
2021-05-04,Purchase,0.0,26.15,209.23
2021-05-04,Cheque,6.56,0.0,215.79
2021-05-04,IMPS,1136766.5,0.0,1136982.29
2021-05-04,IMPS,3.5,0.0,1136985.79
2021-05-04,Miscellaneous,150475.0,0.0,1287460.79
2021-05-04,Debit Card,0.0,128746.08,1158714.71
2021-05-04,Cash,0.0,231742.94,926971.77
2021-05-04,Cheque,87417.0,0.0,1014388.77
2021-05-04,Reversal,4032.0,0.0,1018420.77
2021-05-04,Tax,3199.0,0.0,1021619.77
2021-05-05,RTGS,1259604.5,0.0,2281224.27
2021-05-05,IMPS,0.0,380204.05,1901020.22
2021-05-05,RTGS,100633.75,0.0,2001653.97
2021-05-05,Cash,233897.22,0.0,2235551.19
2021-05-05,NEFT,0.0,2235551.19,0.0
2021-05-05,Commission,6573.9,0.0,6573.9
2021-05-05,RTGS,10.2,0.0,6584.1
2021-05-05,Purchase,0.0,823.01,5761.09
2021-05-05,Cheque,0.0,1152.22,4608.87
2021-05-05,Tax,4553.0,0.0,9161.87
2021-05-05,Miscellaneous,155448.5,0.0,164610.37
2021-05-05,Cash,7463.0,0.0,172073.37
2021-05-05,Transfer,3991.0,0.0,176064.37
2021-05-05,Interest,0.0,35212.87,140851.5
2021-05-05,Tax,0.0,17606.44,123245.06
2021-05-05,Reversal,7.0,0.0,123252.06
2021-05-05,Interest,484224.5,0.0,607476.56
2021-05-05,NEFT,14.0,0.0,607490.56
2021-05-05,Purchase,0.0,86784.37,520706.19
2021-05-05,Reversal,0.0,74386.6,446319.59
2021-05-05,Reversal,0.0,223159.8,223159.8
2021-05-05,Cash,0.0,223159.8,0.0
2021-05-05,Debit Card,502117.0,0.0,502117.0
2021-05-05,Transfer,26.28,0.0,502143.28
2021-05-05,RTGS,0.0,167381.09,334762.19
2021-05-05,Cash,3.0,0.0,334765.19
2021-05-05,NEFT,4284.8,0.0,339049.99
2021-05-05,Reversal,773.18,0.0,339823.17
2021-05-05,RTGS,924657.5,0.0,1264480.67
2021-05-05,Bill,23878.0,0.0,1288358.67
2021-05-05,Bill,0.0,161044.83,1127313.84
2021-05-06,Bill,0.0,112731.38,1014582.46
2021-05-06,IMPS,0.0,507291.23,507291.23
2021-05-06,Purchase,148284.5,0.0,655575.73
2021-05-06,Commission,186.0,0.0,655761.73
2021-05-06,Bill,61.61,0.0,655823.34
2021-05-06,RTGS,0.0,327911.67,327911.67
2021-05-06,RTGS,0.0,81977.92,245933.75
2021-05-06,IMPS,3525.2,0.0,249458.95
2021-05-06,Bill,2.57,0.0,249461.52
2021-05-06,Commission,0.0,31182.69,218278.83
2021-05-06,ATM,122.42,0.0,218401.25
2021-05-06,Commission,17402.0,0.0,235803.25
2021-05-06,Bill,3.6,0.0,235806.85
2021-05-06,Cheque,0.0,29475.86,206330.99
2021-05-06,NEFT,9740.71,0.0,216071.7
2021-05-06,Bill,703623.0,0.0,919694.7
2021-05-06,Cheque,0.0,153282.45,766412.25
2021-05-06,Purchase,0.0,255470.75,510941.5
2021-05-06,Purchase,1151.09,0.0,512092.59
2021-05-06,ATM,12306.0,0.0,524398.59
2021-05-06,Bill,11256.0,0.0,535654.59
2021-05-06,RTGS,29338.8,0.0,564993.39
2021-05-06,Tax,261242.0,0.0,826235.39
2021-05-06,Transfer,116.0,0.0,826351.39
2021-05-06,Cash,0.0,826351.39,0.0
2021-05-06,RTGS,29108.7,0.0,29108.7
2021-05-06,Tax,27136.35,0.0,56245.05
2021-05-06,IMPS,1.1,0.0,56246.15
2021-05-06,Tax,0.0,9374.36,46871.79
2021-05-06,ATM,42.0,0.0,46913.79
2021-05-06,Cash,0.0,15637.93,31275.86
2021-05-06,Cash,424.28,0.0,31700.14
2021-05-06,NEFT,208.0,0.0,31908.14
2021-05-07,Interest,0.0,7977.04,23931.1
2021-05-07,Transfer,8754.0,0.0,32685.1
2021-05-07,Purchase,0.0,3631.68,29053.42
2021-05-07,Transfer,0.0,5810.68,23242.74
2021-05-08,Cheque,0.0,7747.58,15495.16
2021-05-08,Purchase,0.3,0.0,15495.46
2021-05-08,Reversal,0.0,2213.64,13281.82
2021-05-08,RTGS,1392.7,0.0,14674.52
2021-05-08,Interest,204.2,0.0,14878.72
2021-05-08,IMPS,7694.0,0.0,22572.72
2021-05-08,Tax,617332.0,0.0,639904.72
2021-05-08,ATM,0.0,213301.57,426603.15
2021-05-08,ATM,5.53,0.0,426608.68
2021-05-08,RTGS,0.0,60944.1,365664.58
2021-05-08,Reversal,152780.0,0.0,518444.58
2021-05-08,NEFT,0.0,51844.46,466600.12
2021-05-08,NEFT,0.0,155533.37,311066.75
2021-05-08,Purchase,1295560.2,0.0,1606626.95
2021-05-08,Tax,0.0,160662.7,1445964.26
2021-05-08,Miscellaneous,200544.7,0.0,1646508.96
2021-05-08,Commission,254977.4,0.0,1901486.36
2021-05-08,Interest,0.0,316914.39,1584571.97
2021-05-08,Miscellaneous,0.0,264095.33,1320476.64
2021-05-08,Transfer,5.0,0.0,1320481.64
2021-05-08,Cheque,0.0,660240.82,660240.82
2021-05-08,Commission,283.0,0.0,660523.82
2021-05-08,Interest,11300.0,0.0,671823.82
2021-05-08,NEFT,0.0,67182.38,604641.44
2021-05-09,Cash,441.66,0.0,605083.1
2021-05-09,Debit Card,39.2,0.0,605122.3
2021-05-09,Miscellaneous,3857.1,0.0,608979.4
2021-05-09,NEFT,0.0,67664.38,541315.02
2021-05-09,RTGS,418.09,0.0,541733.11
2021-05-09,Bill,0.0,108346.62,433386.49
2021-05-09,Cash,34.0,0.0,433420.49
2021-05-09,RTGS,0.0,43342.05,390078.44
2021-05-09,Reversal,4041.9,0.0,394120.34
2021-05-09,Commission,47.0,0.0,394167.34
2021-05-09,Miscellaneous,0.0,131389.11,262778.23
2021-05-09,Miscellaneous,0.0,43796.37,218981.86
2021-05-09,Interest,142.85,0.0,219124.71
2021-05-09,Tax,0.0,24347.19,194777.52
2021-05-09,Cash,0.0,27825.36,166952.16
2021-05-09,Transfer,0.0,41738.04,125214.12
2021-05-09,ATM,7.0,0.0,125221.12
2021-05-09,Transfer,60875.66,0.0,186096.78
2021-05-09,IMPS,1020.11,0.0,187116.89
2021-05-09,NEFT,0.0,23389.61,163727.28
2021-05-09,Tax,7.4,0.0,163734.68
2021-05-09,Reversal,0.0,20466.84,143267.84
2021-05-09,Tax,0.0,143267.84,0.0
2021-05-09,Tax,5.53,0.0,5.53
2021-05-09,Tax,0.0,2.77,2.76
2021-05-09,IMPS,38.27,0.0,41.03
2021-05-09,Interest,0.0,41.03,0.0
2021-05-09,Purchase,395.6,0.0,395.6
2021-05-09,Debit Card,434.12,0.0,829.72
2021-05-09,Purchase,2.38,0.0,832.1
2021-05-10,Cash,257.1,0.0,1089.2
2021-05-10,Cash,2088867.75,0.0,2089956.95
2021-05-10,Reversal,52.0,0.0,2090008.95
2021-05-10,Bill,38.4,0.0,2090047.35
2021-05-10,Transfer,0.0,232227.48,1857819.87
2021-05-10,Cash,0.0,928909.94,928909.94
2021-05-10,NEFT,105782.56,0.0,1034692.5
2021-05-10,Transfer,0.0,129336.56,905355.94
2021-05-10,Debit Card,0.0,100595.1,804760.84
2021-05-10,Bill,14854.7,0.0,819615.54
2021-05-10,Purchase,0.0,409807.77,409807.77
2021-05-10,Miscellaneous,0.0,136602.59,273205.18
2021-05-10,ATM,0.0,91068.39,182136.79
2021-05-10,Commission,0.0,22767.1,159369.69
2021-05-10,Purchase,3.59,0.0,159373.28
2021-05-10,Transfer,0.0,15937.33,143435.95
2021-05-10,Tax,77732.0,0.0,221167.95
2021-05-10,Interest,0.0,36861.33,184306.62
2021-05-10,Commission,2813.0,0.0,187119.62
2021-05-10,Bill,0.0,20791.07,166328.55
2021-05-10,Interest,22081.88,0.0,188410.43
2021-05-10,Commission,188396.34,0.0,376806.77
2021-05-10,Purchase,0.72,0.0,376807.49
2021-05-10,RTGS,0.0,62801.25,314006.24
2021-05-10,Reversal,990.3,0.0,314996.54
2021-05-10,RTGS,0.0,34999.62,279996.92
2021-05-10,Reversal,0.0,279996.92,0.0
2021-05-10,ATM,404.0,0.0,404.0
2021-05-10,Debit Card,10787.0,0.0,11191.0
2021-05-10,Commission,1053.8,0.0,12244.8
2021-05-10,NEFT,0.0,1749.26,10495.54
2021-05-10,Tax,0.0,1166.17,9329.37
2021-05-10,Transfer,0.0,2332.34,6997.03
2021-05-10,Reversal,0.0,1399.41,5597.62
2021-05-10,IMPS,8933.27,0.0,14530.89
2021-05-10,Purchase,3899.88,0.0,18430.77
2021-05-10,IMPS,0.0,6143.59,12287.18
2021-05-10,RTGS,7.92,0.0,12295.1
2021-05-10,Reversal,1743372.0,0.0,1755667.1
2021-05-10,Miscellaneous,7.66,0.0,1755674.76
2021-05-10,Purchase,0.0,292612.46,1463062.3
2021-05-10,NEFT,0.0,243843.72,1219218.58
2021-05-10,Miscellaneous,1189479.5,0.0,2408698.08
2021-05-11,Interest,0.0,602174.52,1806523.56
2021-05-11,Cash,17638.77,0.0,1824162.33
2021-05-11,Tax,3030.0,0.0,1827192.33
2021-05-11,Commission,0.0,456798.08,1370394.25
2021-05-11,Debit Card,0.0,1370394.25,0.0
2021-05-12,ATM,9279.5,0.0,9279.5
2021-05-12,Cheque,4.0,0.0,9283.5
2021-05-12,Interest,0.0,1856.7,7426.8
2021-05-13,Cheque,0.0,3713.4,3713.4
2021-05-13,Interest,0.0,412.6,3300.8
2021-05-13,Purchase,1220474.75,0.0,1223775.55
2021-05-13,Bill,123175.1,0.0,1346950.65
2021-05-13,Transfer,20514.0,0.0,1367464.65
2021-05-13,Cheque,1.4,0.0,1367466.05
2021-05-13,Debit Card,3.77,0.0,1367469.82
2021-05-13,Cheque,4.0,0.0,1367473.82
2021-05-13,Debit Card,0.0,136747.38,1230726.44
2021-05-13,Reversal,0.0,410242.15,820484.29
2021-05-13,Purchase,54.0,0.0,820538.29
2021-05-13,IMPS,26.9,0.0,820565.19
2021-05-13,Miscellaneous,0.0,91173.91,729391.28
2021-05-13,ATM,0.0,104198.75,625192.53
2021-05-13,Cash,5335.0,0.0,630527.53
2021-05-13,RTGS,498.29,0.0,631025.82
2021-05-13,Interest,0.0,126205.16,504820.66
2021-05-13,Interest,0.4,0.0,504821.06
2021-05-14,Debit Card,0.0,504821.06,0.0
2021-05-14,Cheque,3481.2,0.0,3481.2
2021-05-14,NEFT,0.0,1740.6,1740.6
2021-05-14,NEFT,0.0,348.12,1392.48
2021-05-14,Debit Card,6.74,0.0,1399.22
2021-05-14,Interest,0.0,155.47,1243.75
2021-05-14,Miscellaneous,0.0,177.68,1066.07
2021-05-14,IMPS,206129.1,0.0,207195.17
2021-05-14,Cash,0.0,103597.59,103597.58
2021-05-14,IMPS,0.0,14799.65,88797.93
2021-05-14,Interest,0.0,44398.97,44398.96
2021-05-14,Reversal,4.8,0.0,44403.76
2021-05-14,Miscellaneous,242.19,0.0,44645.95
2021-05-14,Commission,397.1,0.0,45043.05
2021-05-14,Debit Card,0.0,4504.31,40538.75
2021-05-14,Debit Card,0.0,13512.92,27025.83
2021-05-14,IMPS,0.0,13512.92,13512.92
2021-05-14,Tax,0.0,1501.44,12011.48
2021-05-14,NEFT,1666856.0,0.0,1678867.48
2021-05-14,Transfer,20617.16,0.0,1699484.64
2021-05-14,Cash,4095.7,0.0,1703580.34
2021-05-14,Debit Card,791915.5,0.0,2495495.84
2021-05-14,Reversal,22967.2,0.0,2518463.04
2021-05-14,Interest,0.0,419743.84,2098719.2
2021-05-14,Cash,0.0,699573.07,1399146.13
2021-05-14,Transfer,0.0,155460.68,1243685.45
2021-05-14,Cheque,0.0,621842.73,621842.72
2021-05-14,Miscellaneous,367680.0,0.0,989522.72
2021-05-14,Interest,6.3,0.0,989529.02
2021-05-14,Debit Card,0.0,141361.29,848167.73
2021-05-14,Reversal,0.0,106020.97,742146.76
2021-05-14,Reversal,3412.8,0.0,745559.56
2021-05-14,NEFT,0.0,248519.85,497039.71
2021-05-14,Bill,107.0,0.0,497146.71
2021-05-14,Bill,2640.73,0.0,499787.44
2021-05-14,Debit Card,0.0,249893.72,249893.72
2021-05-14,Cheque,0.0,35699.1,214194.62
2021-05-14,Tax,7.1,0.0,214201.72
2021-05-14,IMPS,0.0,214201.72,0.0
2021-05-14,Commission,392.0,0.0,392.0
2021-05-14,Tax,0.0,49.0,343.0
2021-05-14,Reversal,28252.3,0.0,28595.3
2021-05-14,Bill,0.0,3177.26,25418.04
2021-05-14,NEFT,24206.69,0.0,49624.73
2021-05-14,Miscellaneous,7.5,0.0,49632.23
2021-05-14,Interest,32.0,0.0,49664.23
2021-05-14,Purchase,8.0,0.0,49672.23
2021-05-14,Interest,216983.0,0.0,266655.23
2021-05-14,Miscellaneous,1375.0,0.0,268030.23
2021-05-14,Cash,229693.1,0.0,497723.33
2021-05-14,Miscellaneous,6.0,0.0,497729.33
2021-05-14,RTGS,0.0,124432.33,373297.0
2021-05-14,Cheque,0.0,74659.4,298637.6
2021-05-14,Tax,0.0,99545.87,199091.73
2021-05-14,Cheque,0.0,19909.17,179182.56
2021-05-14,Cash,0.0,19909.17,159273.39
2021-05-14,IMPS,79422.0,0.0,238695.39
2021-05-14,Debit Card,38.84,0.0,238734.23
2021-05-15,Commission,3.9,0.0,238738.13
2021-05-15,Commission,40.5,0.0,238778.63
2021-05-15,Bill,0.0,238778.63,0.0
2021-05-15,Transfer,473.7,0.0,473.7
2021-05-15,Interest,0.0,67.67,406.03
2021-05-15,Purchase,109040.0,0.0,109446.03
2021-05-15,RTGS,0.0,54723.02,54723.02
2021-05-15,ATM,5.3,0.0,54728.32
2021-05-15,Commission,0.0,13682.08,41046.24
2021-05-15,Commission,0.0,6841.04,34205.2
2021-05-15,Tax,0.0,34205.2,0.0
2021-05-15,Purchase,10553.7,0.0,10553.7
2021-05-15,Tax,0.0,2638.43,7915.28
2021-05-15,Cash,475449.0,0.0,483364.28
2021-05-15,IMPS,843260.8,0.0,1326625.08
2021-05-15,Debit Card,0.0,147402.79,1179222.29
2021-05-15,RTGS,7.4,0.0,1179229.69
2021-05-15,NEFT,0.0,393076.56,786153.13
2021-05-15,Commission,3585.0,0.0,789738.13
2021-05-15,NEFT,0.0,197434.53,592303.6
2021-05-15,Cheque,27.2,0.0,592330.8
2021-05-15,ATM,0.0,296165.4,296165.4
2021-05-15,Transfer,0.0,148082.7,148082.7
2021-05-15,Purchase,105672.06,0.0,253754.76
2021-05-15,Commission,24.0,0.0,253778.76
2021-05-15,Debit Card,0.0,253778.76,0.0
2021-05-15,Reversal,75.1,0.0,75.1
2021-05-15,Purchase,480.0,0.0,555.1
2021-05-15,Bill,0.0,138.78,416.33
2021-05-15,Tax,0.0,208.17,208.16
2021-05-15,Reversal,0.0,29.74,178.42
2021-05-15,IMPS,0.0,29.74,148.68
2021-05-15,Transfer,1219646.2,0.0,1219794.88
2021-05-15,Bill,51.0,0.0,1219845.88
2021-05-15,Interest,0.0,135538.43,1084307.45
2021-05-15,Reversal,29.42,0.0,1084336.87
2021-05-15,Cheque,0.0,1084336.87,0.0
2021-05-15,Purchase,2222.7,0.0,2222.7
2021-05-16,Bill,0.0,317.53,1905.17
2021-05-16,Tax,31150.0,0.0,33055.17
2021-05-16,Purchase,0.0,33055.17,0.0
2021-05-16,ATM,150.6,0.0,150.6
2021-05-16,Commission,0.0,50.2,100.4
2021-05-16,Cheque,0.0,10.04,90.36
2021-05-16,Bill,0.0,90.36,0.0
2021-05-16,Transfer,30116.3,0.0,30116.3
2021-05-16,Cheque,0.0,3764.54,26351.76
2021-05-16,Transfer,29.0,0.0,26380.76
2021-05-16,Cheque,2.23,0.0,26382.99
2021-05-16,Bill,0.0,3297.87,23085.12
2021-05-16,Cash,0.0,3297.87,19787.25
2021-05-16,Debit Card,0.0,19787.25,0.0
2021-05-16,Cash,49.9,0.0,49.9
2021-05-16,IMPS,0.0,49.9,0.0
2021-05-16,Cash,1.0,0.0,1.0
2021-05-16,Miscellaneous,0.0,0.5,0.5
2021-05-16,Bill,0.0,0.17,0.33
2021-05-16,Commission,2275.41,0.0,2275.74
2021-05-16,RTGS,0.0,252.86,2022.88
2021-05-16,RTGS,0.0,1011.44,1011.44
2021-05-16,ATM,1351827.0,0.0,1352838.44
2021-05-16,NEFT,252031.6,0.0,1604870.04
2021-05-16,Miscellaneous,41924.09,0.0,1646794.13
2021-05-16,Cash,208.0,0.0,1647002.13
2021-05-16,NEFT,818.4,0.0,1647820.53
2021-05-16,Cheque,0.0,329564.11,1318256.42
2021-05-16,Miscellaneous,51.52,0.0,1318307.94
2021-05-16,RTGS,0.0,439435.98,878871.96
2021-05-16,Tax,0.0,175774.39,703097.57
2021-05-16,Purchase,0.0,70309.76,632787.81
2021-05-16,Cash,736998.75,0.0,1369786.56
2021-05-16,Tax,27279.07,0.0,1397065.63
2021-05-16,Purchase,770364.2,0.0,2167429.83
2021-05-16,Reversal,6388.97,0.0,2173818.8
2021-05-16,Debit Card,0.0,310545.54,1863273.26
2021-05-16,Transfer,31.88,0.0,1863305.14
2021-05-16,Miscellaneous,0.0,931652.57,931652.57
2021-05-16,NEFT,1243369.0,0.0,2175021.57
2021-05-16,Bill,2233.09,0.0,2177254.66
2021-05-16,Cheque,0.0,725751.55,1451503.11
2021-05-16,ATM,28.1,0.0,1451531.21
2021-05-16,Miscellaneous,441.0,0.0,1451972.21
2021-05-16,RTGS,0.0,145197.22,1306774.99
2021-05-16,Debit Card,0.0,261355.0,1045419.99
2021-05-16,Cash,0.0,1045419.99,0.0
2021-05-16,Reversal,2634.56,0.0,2634.56
2021-05-16,Interest,0.0,292.73,2341.83
2021-05-16,NEFT,54.68,0.0,2396.51
2021-05-16,Cheque,78641.03,0.0,81037.54
2021-05-16,NEFT,0.0,13506.26,67531.28
2021-05-16,Interest,0.0,16882.82,50648.46
2021-05-16,Debit Card,0.0,6331.06,44317.4
2021-05-16,Purchase,0.0,6331.06,37986.34
2021-05-16,Miscellaneous,0.0,18993.17,18993.17
2021-05-17,ATM,0.0,3798.63,15194.54
2021-05-17,ATM,0.0,1519.45,13675.09
2021-05-17,Cash,0.0,13675.09,0.0
2021-05-17,Transfer,855.8,0.0,855.8
2021-05-17,Transfer,0.0,122.26,733.54
2021-05-17,Purchase,14165.52,0.0,14899.06
2021-05-17,ATM,0.0,1862.38,13036.68
2021-05-17,NEFT,219.07,0.0,13255.75
2021-05-17,Purchase,1.1,0.0,13256.85
2021-05-17,Transfer,14467.6,0.0,27724.45
2021-05-17,Tax,97.74,0.0,27822.19
2021-05-17,Interest,4028.0,0.0,31850.19
2021-05-17,RTGS,0.0,7962.55,23887.64
2021-05-18,Debit Card,0.0,2985.96,20901.68
2021-05-18,RTGS,0.0,6967.23,13934.45
2021-05-18,Cheque,32707.0,0.0,46641.45
2021-05-18,Interest,295.5,0.0,46936.95
2021-05-18,Debit Card,0.0,23468.48,23468.48
2021-05-18,Purchase,0.0,7822.83,15645.65
2021-05-18,Debit Card,0.0,0.0,15645.65
2021-05-18,Tax,0.0,2235.09,13410.56
2021-05-18,Transfer,8.5,0.0,13419.06
2021-05-18,Tax,0.0,2236.51,11182.55
2021-05-18,Bill,5.29,0.0,11187.84
2021-05-18,Miscellaneous,57.31,0.0,11245.15
2021-05-18,NEFT,0.0,3748.38,7496.77
2021-05-18,Transfer,4384.5,0.0,11881.27
2021-05-18,ATM,0.0,1320.14,10561.13
2021-05-18,IMPS,0.0,3520.38,7040.75
2021-05-19,Cash,2.79,0.0,7043.54
2021-05-19,Cash,0.0,7043.54,0.0
2021-05-19,RTGS,15054.7,0.0,15054.7
2021-05-20,Cash,26.33,0.0,15081.03
2021-05-20,IMPS,3354.3,0.0,18435.33
2021-05-20,ATM,0.0,1843.53,16591.8
2021-05-21,Debit Card,0.0,1659.18,14932.62
2021-05-21,Purchase,2.2,0.0,14934.82
2021-05-21,Reversal,0.0,3733.71,11201.12
2021-05-21,RTGS,0.0,1600.16,9600.96
2021-05-21,Bill,0.0,1371.57,8229.39
2021-05-21,Reversal,0.0,1175.63,7053.76
2021-05-21,Cash,0.0,1763.44,5290.32
2021-05-21,Bill,0.0,1763.44,3526.88
2021-05-21,RTGS,107357.8,0.0,110884.68
2021-05-21,Purchase,0.0,12320.52,98564.16
2021-05-21,ATM,1689.9,0.0,100254.06
2021-05-21,Miscellaneous,0.0,50127.03,50127.03
2021-05-22,Cheque,3624.0,0.0,53751.03
2021-05-22,ATM,0.0,8958.51,44792.52
2021-05-22,Transfer,6.0,0.0,44798.52
2021-05-22,Miscellaneous,1820.7,0.0,46619.22
2021-05-22,Reversal,0.0,11654.81,34964.42
2021-05-22,Commission,0.0,8741.11,26223.32
2021-05-22,RTGS,0.0,2622.33,23600.99
2021-05-22,Debit Card,0.0,23600.99,0.0
2021-05-22,ATM,434.05,0.0,434.05
2021-05-22,Bill,70.01,0.0,504.06
2021-05-22,Interest,0.0,252.03,252.03
2021-05-22,Debit Card,0.0,42.01,210.02
2021-05-22,Cash,201562.0,0.0,201772.02
2021-05-22,Cheque,0.0,40354.4,161417.62
2021-05-22,Miscellaneous,0.0,20177.2,141240.42
2021-05-22,Bill,5.43,0.0,141245.85
2021-05-22,Bill,0.0,20177.98,121067.87
2021-05-22,IMPS,0.0,17295.41,103772.46
2021-05-22,Bill,230751.0,0.0,334523.46
2021-05-22,Cash,346.9,0.0,334870.36
2021-05-22,ATM,0.0,66974.07,267896.29
2021-05-22,Cash,157.0,0.0,268053.29
2021-05-22,Debit Card,6.0,0.0,268059.29
2021-05-22,ATM,7.0,0.0,268066.29
2021-05-22,Debit Card,0.0,53613.26,214453.03
2021-05-22,Cheque,51.0,0.0,214504.03
2021-05-22,Tax,1096908.5,0.0,1311412.53
2021-05-22,Debit Card,55584.53,0.0,1366997.06
2021-05-22,Commission,0.0,455665.69,911331.37
2021-05-22,Cheque,246128.2,0.0,1157459.57
2021-05-22,Miscellaneous,0.0,385819.86,771639.71
2021-05-22,Transfer,42.0,0.0,771681.71
2021-05-22,Transfer,0.19,0.0,771681.9
2021-05-22,Commission,0.0,192920.48,578761.43
2021-05-22,IMPS,7.6,0.0,578769.03
2021-05-22,Cheque,51.0,0.0,578820.03
2021-05-22,Miscellaneous,21410.94,0.0,600230.97
2021-05-22,Bill,0.0,66692.33,533538.64
2021-05-22,NEFT,2790.37,0.0,536329.01
2021-05-22,IMPS,1075.0,0.0,537404.01
2021-05-22,Cash,1999527.0,0.0,2536931.01
2021-05-22,Purchase,19.0,0.0,2536950.01
2021-05-22,Cash,140.7,0.0,2537090.71
2021-05-22,ATM,78762.0,0.0,2615852.71
2021-05-22,Purchase,0.0,1307926.36,1307926.36
2021-05-22,Tax,0.0,163490.8,1144435.57
2021-05-22,Purchase,1582803.5,0.0,2727239.07
2021-05-22,Commission,863.0,0.0,2728102.07
2021-05-22,Cheque,0.0,682025.52,2046076.55
2021-05-22,Interest,0.0,2046076.55,0.0
2021-05-22,Interest,1771854.5,0.0,1771854.5
2021-05-22,Tax,56.2,0.0,1771910.7
2021-05-22,Miscellaneous,0.0,442977.68,1328933.02
2021-05-22,IMPS,269.0,0.0,1329202.02
2021-05-22,ATM,123885.0,0.0,1453087.02
2021-05-22,ATM,0.0,484362.34,968724.68
2021-05-22,Commission,0.0,161454.11,807270.57
2021-05-22,Miscellaneous,50152.84,0.0,857423.41
2021-05-22,RTGS,0.0,285807.8,571615.61
2021-05-22,Miscellaneous,466.0,0.0,572081.61
2021-05-22,RTGS,45843.8,0.0,617925.41
2021-05-22,Miscellaneous,0.0,123585.08,494340.33
2021-05-22,Cheque,0.0,494340.33,0.0
2021-05-22,Purchase,3.0,0.0,3.0
2021-05-23,Tax,26889.0,0.0,26892.0
2021-05-23,ATM,134993.59,0.0,161885.59
2021-05-23,Transfer,0.0,32377.12,129508.47
2021-05-24,Interest,16.7,0.0,129525.17
2021-05-24,Transfer,7.0,0.0,129532.17
2021-05-24,Commission,481.8,0.0,130013.97
2021-05-24,ATM,54.04,0.0,130068.01
2021-05-24,ATM,0.0,13006.8,117061.21
2021-05-24,Cheque,0.0,14632.65,102428.56
2021-05-24,RTGS,420.16,0.0,102848.72
2021-05-24,Cheque,22.19,0.0,102870.91
2021-05-24,Transfer,0.0,51435.46,51435.46
2021-05-24,RTGS,0.0,7347.92,44087.54
2021-05-25,Reversal,0.0,5510.94,38576.6
2021-05-25,Reversal,3.0,0.0,38579.6
2021-05-25,Commission,0.0,7715.92,30863.68
2021-05-25,Bill,0.0,5143.95,25719.73
2021-05-25,NEFT,9122.0,0.0,34841.73
2021-05-25,Purchase,0.0,6968.35,27873.38
2021-05-25,Reversal,0.0,6968.35,20905.04
2021-05-26,Cheque,28.5,0.0,20933.54
2021-05-26,Cheque,22487.0,0.0,43420.54
2021-05-26,Tax,75.0,0.0,43495.54
2021-05-26,Debit Card,0.0,7249.26,36246.28
2021-05-27,Debit Card,1521771.0,0.0,1558017.28
2021-05-27,ATM,161643.84,0.0,1719661.12
2021-05-27,Bill,0.0,429915.28,1289745.84
2021-05-27,Reversal,0.0,1289745.84,0.0
2021-05-27,IMPS,29558.0,0.0,29558.0
2021-05-27,Tax,0.0,29558.0,0.0
2021-05-27,IMPS,2225.92,0.0,2225.92
2021-05-27,ATM,0.0,741.97,1483.95
2021-05-27,Commission,0.0,148.4,1335.56
2021-05-27,Debit Card,60.26,0.0,1395.82
2021-05-27,Tax,3588.9,0.0,4984.72
2021-05-27,Bill,0.0,498.47,4486.25
2021-05-27,Miscellaneous,146765.5,0.0,151251.75
2021-05-27,NEFT,0.0,37812.94,113438.81
2021-05-27,Transfer,367.0,0.0,113805.81
2021-05-27,Cash,30790.0,0.0,144595.81
2021-05-27,Reversal,0.0,14459.58,130136.23
2021-05-27,ATM,3.0,0.0,130139.23
2021-05-27,Cash,0.0,65069.62,65069.62
2021-05-27,ATM,0.0,8133.7,56935.92
2021-05-27,Reversal,4.01,0.0,56939.93
2021-05-27,RTGS,0.0,28469.97,28469.96
2021-05-27,Commission,0.0,7117.49,21352.47
2021-05-27,IMPS,0.0,21352.47,0.0
2021-05-27,Transfer,1536781.0,0.0,1536781.0
2021-05-27,Reversal,0.0,1536781.0,0.0
2021-05-27,Interest,1983.0,0.0,1983.0
2021-05-27,Tax,3440.2,0.0,5423.2
2021-05-27,Cash,16559.0,0.0,21982.2
2021-05-27,IMPS,4.3,0.0,21986.5
2021-05-27,Cash,0.0,3664.42,18322.08
2021-05-27,Interest,96425.2,0.0,114747.28
2021-05-27,Cheque,5.28,0.0,114752.56
2021-05-27,Bill,217070.8,0.0,331823.36
2021-05-27,Commission,271.9,0.0,332095.26
2021-05-27,Purchase,14051.19,0.0,346146.45
2021-05-27,Transfer,16089.0,0.0,362235.45
2021-05-27,NEFT,39.0,0.0,362274.45
2021-05-27,Bill,0.0,72454.89,289819.56
2021-05-27,Commission,0.0,32202.17,257617.39
2021-05-27,Debit Card,0.0,85872.46,171744.93
2021-05-27,RTGS,1399.0,0.0,173143.93
2021-05-27,Cheque,534.1,0.0,173678.03
2021-05-27,Purchase,0.0,57892.68,115785.35
2021-05-27,Cash,40.1,0.0,115825.45
2021-05-27,Bill,0.0,12869.49,102955.96
2021-05-27,IMPS,0.0,17159.33,85796.63
2021-05-27,Interest,0.0,9532.96,76263.67
2021-05-27,Bill,0.0,25421.22,50842.45
2021-05-27,RTGS,2920.3,0.0,53762.75
2021-05-27,Debit Card,0.0,13440.69,40322.06
2021-05-27,Bill,0.0,40322.06,0.0
2021-05-27,Purchase,2.6,0.0,2.6
2021-05-27,Debit Card,59.46,0.0,62.06
2021-05-27,Transfer,146779.4,0.0,146841.46
2021-05-27,Debit Card,0.0,16315.72,130525.74
2021-05-27,Transfer,52.0,0.0,130577.74
2021-05-27,Cheque,17.0,0.0,130594.74
2021-05-27,Transfer,0.0,18656.39,111938.35
2021-05-27,Reversal,416.5,0.0,112354.85
2021-05-27,Interest,0.0,37451.62,74903.23
2021-05-27,Miscellaneous,53.5,0.0,74956.73
2021-05-27,Debit Card,0.0,14991.35,59965.38
2021-05-27,Reversal,0.0,9994.23,49971.15
2021-05-28,NEFT,0.0,24985.58,24985.58
2021-05-28,Miscellaneous,18862.0,0.0,43847.58
2021-05-28,Commission,0.0,7307.93,36539.65
2021-05-28,Commission,0.0,4567.46,31972.19
2021-05-28,IMPS,0.0,7993.05,23979.14
2021-05-28,NEFT,48.25,0.0,24027.39
2021-05-28,RTGS,0.0,4004.57,20022.82
2021-05-28,Transfer,299.3,0.0,20322.12
2021-05-28,RTGS,0.0,2540.27,17781.86
2021-05-28,Reversal,0.0,3556.37,14225.49
2021-05-28,Miscellaneous,0.0,1422.55,12802.94
2021-05-28,ATM,40.4,0.0,12843.34
2021-05-28,ATM,0.0,1605.42,11237.92
2021-05-28,Bill,9.0,0.0,11246.92
2021-05-28,Cheque,0.0,3748.97,7497.95
2021-05-28,Reversal,0.0,1249.66,6248.29
2021-05-28,Miscellaneous,0.0,1041.38,5206.91
2021-05-28,Transfer,0.0,5206.91,0.0
2021-05-28,Debit Card,1797464.5,0.0,1797464.5
2021-05-28,Miscellaneous,20638.75,0.0,1818103.25
2021-05-28,ATM,0.0,181810.33,1636292.92
2021-05-28,Tax,2759.71,0.0,1639052.63
2021-05-28,NEFT,143.76,0.0,1639196.39
2021-05-28,Transfer,2479.0,0.0,1641675.39
2021-05-28,IMPS,0.0,273612.57,1368062.82
2021-05-28,Commission,0.0,228010.47,1140052.35
2021-05-28,ATM,6.0,0.0,1140058.35
2021-05-28,ATM,1853846.0,0.0,2993904.35
2021-05-28,Tax,0.0,598780.87,2395123.48
2021-05-28,Bill,2.59,0.0,2395126.07
2021-05-28,Bill,0.0,342160.87,2052965.2
2021-05-28,NEFT,475.5,0.0,2053440.7
2021-05-28,RTGS,0.0,205344.07,1848096.63
2021-05-28,Reversal,0.0,264013.8,1584082.83
2021-05-28,Cash,80.41,0.0,1584163.24
2021-05-28,Cash,204479.53,0.0,1788642.77
2021-05-28,Cheque,0.0,447160.69,1341482.08
2021-05-28,Purchase,0.0,447160.69,894321.39
2021-05-28,Commission,4.7,0.0,894326.09
2021-05-28,Tax,2279.06,0.0,896605.15
2021-05-28,RTGS,0.0,224151.29,672453.86
2021-05-28,Cheque,0.0,672453.86,0.0
2021-05-28,Debit Card,31907.41,0.0,31907.41
2021-05-28,IMPS,488.8,0.0,32396.21
2021-05-28,Cheque,0.0,4049.53,28346.68
2021-05-28,Transfer,32742.0,0.0,61088.68
2021-05-29,Miscellaneous,0.0,10181.45,50907.23
2021-05-29,Bill,383.9,0.0,51291.13
2021-05-29,Interest,0.0,8548.52,42742.61
2021-05-29,Purchase,61.94,0.0,42804.55
2021-05-29,Cheque,9574.76,0.0,52379.31
2021-05-29,Miscellaneous,2.0,0.0,52381.31
2021-05-29,Tax,0.0,52381.31,0.0
2021-05-29,Reversal,88.8,0.0,88.8
2021-05-29,IMPS,1275.0,0.0,1363.8
2021-05-29,Tax,0.0,1363.8,0.0
2021-05-29,Interest,4.0,0.0,4.0
2021-05-29,Interest,332.06,0.0,336.06
2021-05-29,Cheque,122657.0,0.0,122993.06
2021-05-29,Cash,0.0,12299.31,110693.75
2021-05-29,Cheque,0.0,12299.31,98394.44
2021-05-29,Transfer,0.0,12299.31,86095.14
2021-05-29,Purchase,0.0,9566.13,76529.01
2021-05-29,Bill,66.9,0.0,76595.91
2021-05-29,RTGS,372.0,0.0,76967.91
2021-05-29,ATM,22255.0,0.0,99222.91
2021-05-29,IMPS,54.43,0.0,99277.34
2021-05-29,Cheque,0.0,33092.45,66184.89
2021-05-29,Reversal,0.0,22061.63,44123.26
2021-05-29,Commission,0.0,4412.33,39710.93
2021-05-29,NEFT,0.0,9927.73,29783.2
2021-05-29,RTGS,0.0,29783.2,0.0
2021-05-29,Transfer,2343.8,0.0,2343.8
2021-05-29,Reversal,7.0,0.0,2350.8
2021-05-29,IMPS,4.02,0.0,2354.82
2021-05-29,Commission,0.0,235.48,2119.34
2021-05-29,Tax,9015.19,0.0,11134.53
2021-05-29,Tax,0.0,5567.27,5567.26
2021-05-29,Tax,0.0,1855.75,3711.51
2021-05-29,Interest,1.0,0.0,3712.51
2021-05-29,Bill,232119.0,0.0,235831.51
2021-05-29,Reversal,706762.75,0.0,942594.26
2021-05-29,Tax,0.0,188518.85,754075.41
2021-05-29,Cash,0.0,94259.43,659815.98
2021-05-29,Purchase,0.0,164954.0,494861.98
2021-05-29,Cash,0.0,247430.99,247430.99
2021-05-29,Miscellaneous,0.0,49486.2,197944.79
2021-05-29,Commission,0.0,21993.87,175950.92
2021-05-29,Transfer,0.0,21993.87,153957.06
2021-05-29,Bill,0.0,38489.27,115467.8
2021-05-29,IMPS,1263454.5,0.0,1378922.3
2021-05-29,ATM,0.6,0.0,1378922.9
2021-05-29,Tax,15.74,0.0,1378938.64
2021-05-29,Transfer,0.0,153215.4,1225723.24
2021-05-29,Tax,5.8,0.0,1225729.04
2021-05-29,Bill,0.0,122572.9,1103156.14
2021-05-29,Transfer,0.0,275789.04,827367.1
2021-05-29,Tax,2191.92,0.0,829559.02
2021-05-29,Cash,75.0,0.0,829634.02
2021-05-29,Purchase,3946.0,0.0,833580.02
2021-05-29,Purchase,203317.8,0.0,1036897.82
2021-05-29,Interest,15692.65,0.0,1052590.47
2021-05-29,Tax,1855.3,0.0,1054445.77
2021-05-29,ATM,3.0,0.0,1054448.77
2021-05-29,Tax,0.0,263612.19,790836.58
2021-05-29,Transfer,0.0,112976.65,677859.93
2021-05-29,NEFT,0.0,67785.99,610073.94
2021-05-29,ATM,1183.0,0.0,611256.94
2021-05-29,Miscellaneous,73.0,0.0,611329.94
2021-05-29,ATM,0.0,122265.99,489063.95
2021-05-29,Miscellaneous,0.0,489063.95,0.0
2021-05-29,Miscellaneous,36.45,0.0,36.45
2021-05-29,RTGS,0.0,7.29,29.16
2021-05-29,Interest,0.0,3.24,25.92
2021-05-29,Interest,125536.5,0.0,125562.42
2021-05-29,Cheque,28621.9,0.0,154184.32
2021-05-29,Interest,3125.1,0.0,157309.42
2021-05-29,Transfer,3.5,0.0,157312.92
2021-05-29,Commission,1232.1,0.0,158545.02
2021-05-29,NEFT,0.0,17616.11,140928.91
2021-05-29,Reversal,0.0,17616.11,123312.8
2021-05-29,ATM,3.4,0.0,123316.2
2021-05-29,Tax,455.86,0.0,123772.06
2021-05-29,Cash,0.0,13752.45,110019.61
2021-05-29,ATM,0.0,27504.9,82514.71
2021-05-29,NEFT,0.0,16502.94,66011.77
2021-05-29,Commission,535.0,0.0,66546.77
2021-05-29,Debit Card,0.0,33273.39,33273.38
2021-05-29,Commission,0.0,6654.68,26618.7
2021-05-29,Cheque,0.0,2661.87,23956.83
2021-05-29,ATM,0.0,23956.83,0.0
2021-05-29,Bill,4.9,0.0,4.9
2021-05-29,Reversal,1449094.0,0.0,1449098.9
2021-05-29,NEFT,0.0,207014.13,1242084.77
2021-05-29,Interest,0.0,155260.6,1086824.17
2021-05-30,Bill,162.31,0.0,1086986.48
2021-05-30,IMPS,0.0,362328.83,724657.65
2021-05-30,ATM,0.0,362328.83,362328.82
2021-05-30,Interest,0.0,90582.21,271746.62
2021-05-30,Cash,51.1,0.0,271797.72
2021-05-30,Cash,343.7,0.0,272141.42
2021-05-30,Cash,131161.0,0.0,403302.42
2021-05-30,Bill,0.0,50412.8,352889.62
2021-05-30,Miscellaneous,365.0,0.0,353254.62
2021-05-30,Miscellaneous,0.0,39250.51,314004.11
2021-05-30,Commission,0.0,78501.03,235503.08
2021-05-30,Cheque,0.0,26167.01,209336.07
2021-05-30,Tax,1177.0,0.0,210513.07
2021-05-30,Reversal,462.56,0.0,210975.63
2021-05-30,Purchase,22991.0,0.0,233966.63
2021-05-30,Interest,0.0,29245.83,204720.8
2021-05-30,Commission,0.0,22746.76,181974.04
2021-05-30,Cheque,0.0,45493.51,136480.53
2021-05-30,ATM,4.7,0.0,136485.23
2021-05-30,Miscellaneous,21377.8,0.0,157863.03
2021-05-30,Interest,0.0,52621.01,105242.02
2021-05-30,Cash,52.0,0.0,105294.02
2021-05-30,Bill,0.0,35098.01,70196.01
2021-05-30,Tax,50.2,0.0,70246.21
2021-05-30,Miscellaneous,884441.25,0.0,954687.46
2021-05-30,Bill,60.1,0.0,954747.56
2021-05-31,Cheque,39.0,0.0,954786.56
2021-05-31,Bill,0.0,190957.31,763829.25
2021-05-31,Miscellaneous,0.0,76382.93,687446.32
2021-05-31,Purchase,0.0,85930.79,601515.53
2021-05-31,Miscellaneous,0.0,300757.77,300757.76
2021-05-31,ATM,0.0,300757.76,0.0
2021-05-31,Cash,259.8,0.0,259.8
2021-05-31,Interest,0.0,86.6,173.2
2021-05-31,NEFT,49514.0,0.0,49687.2
2021-05-31,RTGS,0.0,49687.2,0.0
2021-05-31,Cheque,13.0,0.0,13.0
2021-05-31,Transfer,54.47,0.0,67.47
2021-05-31,Cheque,0.0,33.74,33.74
2021-05-31,Cash,2075.0,0.0,2108.74
2021-05-31,Bill,177.3,0.0,2286.04
2021-05-31,Commission,15167.0,0.0,17453.04
2021-05-31,Miscellaneous,862483.0,0.0,879936.04
2021-05-31,NEFT,0.0,125705.15,754230.89
2021-05-31,Transfer,3212.33,0.0,757443.22
2021-05-31,Commission,0.0,126240.54,631202.68
2021-05-31,Tax,0.0,78900.34,552302.35
2021-06-01,RTGS,0.0,92050.39,460251.96
2021-06-01,Cheque,0.0,92050.39,368201.57
2021-06-01,IMPS,2.47,0.0,368204.04
2021-06-01,RTGS,0.0,61367.34,306836.7
2021-06-01,Commission,7.41,0.0,306844.11
2021-06-01,Miscellaneous,3494.0,0.0,310338.11
2021-06-01,Cheque,17319.0,0.0,327657.11
2021-06-01,Commission,29497.68,0.0,357154.79
2021-06-01,Cheque,0.0,71430.96,285723.83
2021-06-01,Tax,0.0,47620.64,238103.19
2021-06-01,NEFT,1763.6,0.0,239866.79
2021-06-01,RTGS,10480.48,0.0,250347.27
2021-06-01,IMPS,0.0,62586.82,187760.45
2021-06-01,Cash,0.0,23470.06,164290.39
2021-06-01,IMPS,0.0,23470.06,140820.33
2021-06-01,Tax,0.0,15646.7,125173.63
2021-06-01,Reversal,28311.5,0.0,153485.13
2021-06-01,Cash,0.0,19185.64,134299.49
2021-06-01,Bill,7.31,0.0,134306.8
2021-06-01,Miscellaneous,26.0,0.0,134332.8
2021-06-01,NEFT,0.0,16791.6,117541.2
2021-06-01,Transfer,131.0,0.0,117672.2
2021-06-01,Cash,0.0,58836.1,58836.1
2021-06-01,Reversal,0.0,58836.1,0.0
2021-06-01,Transfer,3047.1,0.0,3047.1
2021-06-01,Bill,0.0,1015.7,2031.4
2021-06-01,Commission,0.0,338.57,1692.83
2021-06-01,Reversal,0.0,169.28,1523.55
2021-06-01,ATM,0.0,507.85,1015.7
2021-06-01,Interest,0.0,507.85,507.85
2021-06-01,ATM,1935.0,0.0,2442.85
2021-06-01,Debit Card,0.0,814.28,1628.57
2021-06-02,Interest,748612.0,0.0,750240.57
2021-06-02,Reversal,256.0,0.0,750496.57
2021-06-02,RTGS,101946.0,0.0,852442.57
2021-06-02,Tax,0.0,284147.52,568295.05
2021-06-02,Debit Card,45591.8,0.0,613886.85
2021-06-03,Commission,0.0,102314.48,511572.38
2021-06-03,Reversal,0.0,255786.19,255786.19
2021-06-03,RTGS,613763.75,0.0,869549.94
2021-06-03,Bill,427.0,0.0,869976.94
2021-06-03,Cheque,2.83,0.0,869979.77
2021-06-03,Cash,2934.5,0.0,872914.27
2021-06-04,Cheque,52.5,0.0,872966.77
2021-06-04,Debit Card,56338.6,0.0,929305.37
2021-06-04,Tax,53.0,0.0,929358.37
2021-06-04,Cheque,0.0,309786.12,619572.25
2021-06-04,Debit Card,0.0,123914.45,495657.8
2021-06-04,RTGS,1650.0,0.0,497307.8
2021-06-04,NEFT,50.8,0.0,497358.6
2021-06-04,Tax,0.0,497358.6,0.0
2021-06-04,Reversal,2432.0,0.0,2432.0
2021-06-04,Interest,0.0,1216.0,1216.0
2021-06-04,Miscellaneous,360.0,0.0,1576.0
2021-06-04,IMPS,28216.06,0.0,29792.06
2021-06-04,Bill,0.0,14896.03,14896.03
2021-06-04,NEFT,4.0,0.0,14900.03
2021-06-04,Tax,20986.66,0.0,35886.69
2021-06-04,Interest,0.0,11962.23,23924.46
2021-06-04,NEFT,1257794.75,0.0,1281719.21
2021-06-04,Bill,0.0,640859.61,640859.6
2021-06-04,Tax,0.0,640859.6,0.0
2021-06-04,Commission,3.21,0.0,3.21
2021-06-04,Interest,0.0,3.21,0.0
2021-06-04,IMPS,64.0,0.0,64.0
2021-06-04,Transfer,0.0,8.0,56.0
2021-06-04,ATM,0.0,14.0,42.0
2021-06-04,Bill,1.0,0.0,43.0
2021-06-04,Purchase,0.0,7.17,35.83
2021-06-05,Cheque,3826.87,0.0,3862.7
2021-06-05,Tax,0.0,643.78,3218.92
2021-06-05,RTGS,0.0,1609.46,1609.46
2021-06-05,ATM,0.0,201.18,1408.28
2021-06-05,Transfer,0.0,281.66,1126.62
2021-06-05,Commission,0.0,187.77,938.85
2021-06-05,Purchase,28081.23,0.0,29020.08
2021-06-06,Commission,251422.0,0.0,280442.08
2021-06-06,RTGS,1701924.2,0.0,1982366.28
2021-06-06,IMPS,7519.59,0.0,1989885.87
2021-06-06,Cheque,0.0,284269.41,1705616.46
2021-06-06,Tax,2048327.5,0.0,3753943.96
2021-06-06,Commission,1593.6,0.0,3755537.56
2021-06-06,Interest,0.0,751107.51,3004430.05
2021-06-06,Miscellaneous,0.0,500738.34,2503691.71
2021-06-06,Commission,0.0,1251845.86,1251845.86
2021-06-06,Tax,0.0,417281.95,834563.91
2021-06-06,Bill,1266396.0,0.0,2100959.91
2021-06-06,Cheque,0.0,210095.99,1890863.92
2021-06-06,Reversal,0.0,630287.97,1260575.95
2021-06-06,Bill,0.0,180082.28,1080493.67
2021-06-06,IMPS,29475.0,0.0,1109968.67
2021-06-06,Miscellaneous,6085.0,0.0,1116053.67
2021-06-06,Debit Card,0.0,279013.42,837040.25
2021-06-06,Purchase,2.0,0.0,837042.25
2021-06-06,RTGS,24202.2,0.0,861244.45
2021-06-07,ATM,0.0,95693.83,765550.62
2021-06-07,Miscellaneous,0.0,382775.31,382775.31
2021-06-07,Debit Card,0.0,42530.59,340244.72
2021-06-07,ATM,1819005.0,0.0,2159249.72
2021-06-07,Transfer,2.0,0.0,2159251.72
2021-06-07,Reversal,0.0,239916.86,1919334.86
2021-06-07,Cash,1846870.25,0.0,3766205.11
2021-06-07,Cheque,23.22,0.0,3766228.33
2021-06-07,Purchase,0.0,1883114.17,1883114.16
2021-06-07,RTGS,3563.77,0.0,1886677.93
2021-06-07,Debit Card,6.0,0.0,1886683.93
2021-06-07,NEFT,21954.8,0.0,1908638.73
2021-06-07,Bill,0.0,954319.37,954319.36
2021-06-07,Transfer,0.0,318106.45,636212.91
2021-06-07,Bill,4.04,0.0,636216.95
2021-06-07,Transfer,0.0,159054.24,477162.71
2021-06-07,NEFT,0.0,238581.36,238581.36
2021-06-07,IMPS,3.88,0.0,238585.24
2021-06-07,Interest,0.0,79528.41,159056.83
2021-06-07,RTGS,1783401.0,0.0,1942457.83
2021-06-08,Commission,0.0,215828.65,1726629.18
2021-06-08,Cheque,246.0,0.0,1726875.18
2021-06-08,Reversal,0.0,215859.4,1511015.78
2021-06-08,Miscellaneous,0.0,755507.89,755507.89
2021-06-08,Miscellaneous,0.0,188876.97,566630.92
2021-06-08,Purchase,135814.7,0.0,702445.62
2021-06-08,Debit Card,25260.08,0.0,727705.7
2021-06-08,IMPS,0.0,242568.57,485137.13
2021-06-08,Tax,113454.3,0.0,598591.43
2021-06-08,Tax,0.0,99765.24,498826.19
2021-06-08,Debit Card,1262344.2,0.0,1761170.39
2021-06-08,Reversal,0.0,587056.8,1174113.59
2021-06-08,NEFT,1418.64,0.0,1175532.23
2021-06-08,IMPS,0.0,167933.18,1007599.05
2021-06-08,Cheque,185525.4,0.0,1193124.45
2021-06-08,Cash,6.1,0.0,1193130.55
2021-06-08,Purchase,0.0,596565.28,596565.28
2021-06-08,Commission,0.0,66285.03,530280.25
2021-06-08,Bill,399.5,0.0,530679.75
2021-06-08,Transfer,0.0,132669.94,398009.81
2021-06-08,IMPS,4075.18,0.0,402084.99
2021-06-08,NEFT,0.0,402084.99,0.0
2021-06-08,NEFT,28139.27,0.0,28139.27
2021-06-08,RTGS,429.0,0.0,28568.27
2021-06-08,Debit Card,0.0,4761.38,23806.89
2021-06-08,Purchase,2034076.0,0.0,2057882.89
2021-06-08,Commission,0.0,293983.27,1763899.62
2021-06-08,Commission,0.0,440974.91,1322924.72
2021-06-08,Cash,56.52,0.0,1322981.24
2021-06-08,ATM,22224.0,0.0,1345205.24
2021-06-08,Commission,120.65,0.0,1345325.89
2021-06-08,Interest,0.0,134532.59,1210793.3
2021-06-08,NEFT,258.0,0.0,1211051.3
2021-06-08,IMPS,0.0,151381.41,1059669.89
2021-06-08,IMPS,0.0,105966.99,953702.9
2021-06-08,Cheque,161.0,0.0,953863.9
2021-06-08,Miscellaneous,1.0,0.0,953864.9
2021-06-08,Cheque,0.0,476932.45,476932.45
2021-06-08,Cheque,0.0,238466.23,238466.22
2021-06-08,RTGS,3778.23,0.0,242244.45
2021-06-08,Debit Card,0.0,242244.45,0.0
2021-06-08,Miscellaneous,13763.0,0.0,13763.0
2021-06-08,Debit Card,0.0,1720.38,12042.62
2021-06-08,Interest,3125.0,0.0,15167.62
2021-06-08,Interest,0.0,3791.91,11375.72
2021-06-08,NEFT,557475.5,0.0,568851.22
2021-06-08,Purchase,494.0,0.0,569345.22
2021-06-08,IMPS,0.0,71168.15,498177.07
2021-06-08,Cheque,164218.09,0.0,662395.16
2021-06-08,Debit Card,12.7,0.0,662407.86
2021-06-08,RTGS,0.0,165601.97,496805.9
2021-06-08,Cheque,0.0,124201.48,372604.43
2021-06-08,Interest,0.0,46575.55,326028.88
2021-06-08,NEFT,0.0,36225.43,289803.45
2021-06-08,Debit Card,0.0,48300.58,241502.88
2021-06-08,ATM,0.0,30187.86,211315.02
2021-06-08,Commission,44.0,0.0,211359.02
2021-06-08,Debit Card,24135.8,0.0,235494.82
2021-06-08,Commission,4349.53,0.0,239844.35
2021-06-08,RTGS,250125.8,0.0,489970.15
2021-06-08,IMPS,0.0,97994.03,391976.12
2021-06-08,Miscellaneous,0.0,97994.03,293982.09
2021-06-08,Reversal,32328.0,0.0,326310.09
2021-06-08,Debit Card,4.0,0.0,326314.09
2021-06-08,Cheque,44.49,0.0,326358.58
2021-06-08,Cash,0.0,36262.06,290096.52
2021-06-08,Commission,0.0,58019.3,232077.22
2021-06-08,Interest,0.0,29009.65,203067.57
2021-06-09,Reversal,0.0,22563.06,180504.51
2021-06-09,NEFT,63.0,0.0,180567.51
2021-06-09,Cheque,878133.2,0.0,1058700.71
2021-06-09,Purchase,0.0,117633.41,941067.3
2021-06-09,Debit Card,0.0,94106.73,846960.57
2021-06-09,Bill,1600800.0,0.0,2447760.57
2021-06-09,IMPS,2084.1,0.0,2449844.67
2021-06-09,Reversal,1.94,0.0,2449846.61
2021-06-09,NEFT,0.0,349978.09,2099868.52
2021-06-09,Purchase,0.0,299981.22,1799887.3
2021-06-09,NEFT,0.0,449971.83,1349915.48
2021-06-09,Miscellaneous,166048.62,0.0,1515964.1
2021-06-09,IMPS,0.0,303192.82,1212771.28
2021-06-09,Bill,0.0,151596.41,1061174.87
2021-06-09,Interest,175.5,0.0,1061350.37
2021-06-09,Cheque,0.0,106135.04,955215.33
2021-06-09,RTGS,0.0,106135.04,849080.29
2021-06-09,NEFT,2.2,0.0,849082.49
2021-06-09,Cash,0.0,121297.5,727784.99
2021-06-09,NEFT,79943.4,0.0,807728.39
2021-06-09,IMPS,186.79,0.0,807915.18
2021-06-09,Bill,3.0,0.0,807918.18
2021-06-09,Cash,0.0,201979.55,605938.64
2021-06-09,Interest,0.0,60593.86,545344.78
2021-06-09,Interest,0.0,77906.4,467438.38
2021-06-09,IMPS,0.94,0.0,467439.32
2021-06-09,Purchase,0.0,155813.11,311626.21
2021-06-09,Purchase,12119.77,0.0,323745.98
2021-06-09,Miscellaneous,3.0,0.0,323748.98
2021-06-09,Transfer,4.0,0.0,323752.98
2021-06-09,Transfer,0.0,161876.49,161876.49
2021-06-09,Interest,1339.0,0.0,163215.49
2021-06-09,Purchase,981895.75,0.0,1145111.24
2021-06-09,Interest,0.0,163587.32,981523.92
2021-06-09,Reversal,0.0,196304.78,785219.14
2021-06-09,ATM,0.0,112174.16,673044.98
2021-06-09,Cash,0.0,96149.28,576895.7
2021-06-09,RTGS,0.0,144223.93,432671.78
2021-06-09,Purchase,0.0,72111.96,360559.82
2021-06-09,Transfer,0.0,72111.96,288447.86
2021-06-10,Tax,0.0,28844.79,259603.07
2021-06-10,Commission,0.0,43267.18,216335.89
2021-06-10,Cheque,0.0,27041.99,189293.9
2021-06-10,Reversal,213213.0,0.0,402506.9
2021-06-10,Cheque,0.0,80501.38,322005.52
2021-06-10,Miscellaneous,4283.2,0.0,326288.72
2021-06-10,Debit Card,55.8,0.0,326344.52
2021-06-10,Interest,0.0,163172.26,163172.26
2021-06-10,ATM,96.0,0.0,163268.26
2021-06-10,Transfer,0.0,16326.83,146941.43
2021-06-10,Transfer,0.0,16326.83,130614.6
2021-06-10,NEFT,0.0,65307.3,65307.3
2021-06-10,Purchase,0.0,16326.83,48980.48
2021-06-10,Bill,1137316.0,0.0,1186296.48
2021-06-10,NEFT,23.0,0.0,1186319.48
2021-06-10,Cash,0.0,593159.74,593159.74
2021-06-10,IMPS,0.0,197719.91,395439.83
2021-06-10,ATM,3542.0,0.0,398981.83
2021-06-10,Bill,0.0,44331.31,354650.52
2021-06-10,Tax,0.0,177325.26,177325.26
2021-06-10,Tax,11.0,0.0,177336.26
2021-06-10,Commission,1690.49,0.0,179026.75
2021-06-10,Interest,180864.3,0.0,359891.05
2021-06-10,Commission,0.0,51413.01,308478.04
2021-06-10,Bill,168404.0,0.0,476882.04
2021-06-10,Cash,0.0,47688.2,429193.84
2021-06-10,IMPS,0.0,429193.84,0.0
2021-06-10,IMPS,6.0,0.0,6.0
2021-06-10,Interest,0.0,6.0,0.0
2021-06-10,NEFT,6.78,0.0,6.78
2021-06-10,IMPS,0.0,0.85,5.93
2021-06-10,Reversal,501386.0,0.0,501391.93
2021-06-10,Interest,0.0,501391.93,0.0
2021-06-10,Reversal,53.0,0.0,53.0
2021-06-10,Tax,26000.0,0.0,26053.0
2021-06-10,Reversal,0.0,2605.3,23447.7
2021-06-10,Miscellaneous,0.0,7815.9,15631.8
2021-06-10,Miscellaneous,12.92,0.0,15644.72
2021-06-10,Cash,42.9,0.0,15687.62
2021-06-10,Reversal,0.0,3137.52,12550.1
2021-06-10,Interest,218.0,0.0,12768.1
2021-06-10,ATM,2196.13,0.0,14964.23
2021-06-10,RTGS,0.0,1496.42,13467.81
2021-06-10,Debit Card,7.6,0.0,13475.41
2021-06-10,Cheque,0.0,3368.85,10106.56
2021-06-10,Miscellaneous,0.65,0.0,10107.21
2021-06-10,NEFT,0.0,1123.02,8984.19
2021-06-10,ATM,0.0,4492.1,4492.1
2021-06-10,Miscellaneous,2037553.8,0.0,2042045.9
2021-06-10,ATM,0.0,680681.97,1361363.93
2021-06-10,Reversal,0.0,226893.99,1134469.94
2021-06-10,NEFT,2894.8,0.0,1137364.74
2021-06-10,Transfer,0.0,568682.37,568682.37
2021-06-10,Tax,0.0,142170.59,426511.78
2021-06-10,Tax,0.0,42651.18,383860.6
2021-06-10,Tax,0.0,54837.23,329023.37
2021-06-10,Commission,0.0,164511.69,164511.68
2021-06-10,Reversal,152862.0,0.0,317373.68
2021-06-10,Cheque,0.0,35263.74,282109.94
2021-06-10,Bill,4078.0,0.0,286187.94
2021-06-10,Interest,0.0,31798.66,254389.28
2021-06-10,Commission,0.0,254389.28,0.0
2021-06-10,Bill,194432.0,0.0,194432.0
2021-06-10,NEFT,0.0,64810.67,129621.33
2021-06-10,Debit Card,0.0,18517.33,111104.0
2021-06-10,Purchase,268035.5,0.0,379139.5
2021-06-10,Commission,67316.4,0.0,446455.9
2021-06-10,Interest,0.0,49606.21,396849.69
2021-06-10,Commission,5.0,0.0,396854.69
2021-06-10,IMPS,0.0,56693.53,340161.16
2021-06-10,NEFT,0.0,68032.23,272128.93
2021-06-10,Debit Card,0.0,38875.56,233253.37
2021-06-10,Reversal,0.0,58313.34,174940.03
2021-06-10,Tax,0.0,17494.0,157446.03
2021-06-10,Interest,0.0,22492.29,134953.74
2021-06-10,RTGS,0.0,22492.29,112461.45
2021-06-10,Commission,64.0,0.0,112525.45
2021-06-10,IMPS,6.0,0.0,112531.45
2021-06-10,Cheque,0.0,18755.24,93776.21
2021-06-10,Reversal,27791.2,0.0,121567.41
2021-06-11,IMPS,149001.22,0.0,270568.63
2021-06-11,Debit Card,0.0,135284.32,135284.32
2021-06-11,Transfer,4.03,0.0,135288.35
2021-06-11,Cheque,0.0,16911.04,118377.31
2021-06-11,Bill,0.0,59188.66,59188.66
2021-06-11,NEFT,102826.5,0.0,162015.16
2021-06-11,Tax,0.0,27002.53,135012.63
2021-06-11,Debit Card,0.0,13501.26,121511.37
2021-06-11,Transfer,0.0,17358.77,104152.6
2021-06-11,Miscellaneous,0.0,26038.15,78114.45
2021-06-11,Transfer,299.79,0.0,78414.24
2021-06-11,Interest,0.0,78414.24,0.0
2021-06-11,IMPS,6.0,0.0,6.0
2021-06-11,Commission,0.0,0.75,5.25
2021-06-11,Debit Card,20.4,0.0,25.65
2021-06-11,Reversal,0.0,8.55,17.1
2021-06-11,Tax,14127.0,0.0,14144.1
2021-06-11,Cash,0.0,4714.7,9429.4
2021-06-11,Debit Card,0.0,1047.71,8381.69
2021-06-11,Debit Card,0.0,1197.38,7184.31
2021-06-11,Cash,0.0,1796.08,5388.23
2021-06-11,Reversal,1244.9,0.0,6633.13
2021-06-11,Purchase,0.64,0.0,6633.77
2021-06-12,Cash,5.2,0.0,6638.97
2021-06-13,NEFT,0.0,829.87,5809.1
2021-06-13,Cheque,0.0,726.14,5082.96
2021-06-13,Cash,23058.0,0.0,28140.96
2021-06-13,Debit Card,0.0,3517.62,24623.34
2021-06-13,RTGS,0.0,4924.67,19698.67
2021-06-13,Bill,381868.0,0.0,401566.67
2021-06-13,Cash,758.4,0.0,402325.07
2021-06-13,Debit Card,0.0,40232.51,362092.56
2021-06-13,ATM,0.0,45261.57,316830.99
2021-06-13,Interest,0.0,105610.33,211220.66
2021-06-14,Commission,0.0,211220.66,0.0
2021-06-14,Commission,7.76,0.0,7.76
2021-06-14,IMPS,3523.0,0.0,3530.76
2021-06-14,Cash,9328.04,0.0,12858.8
2021-06-14,Cash,0.0,4286.27,8572.53
2021-06-14,Reversal,129.6,0.0,8702.13
2021-06-14,Commission,0.0,8702.13,0.0
2021-06-14,Cash,0.87,0.0,0.87
2021-06-14,Tax,1.0,0.0,1.87
2021-06-14,Purchase,0.0,1.87,0.0
2021-06-15,ATM,345.13,0.0,345.13
2021-06-15,Transfer,0.0,43.14,301.99
2021-06-15,Purchase,0.0,100.66,201.33
2021-06-15,RTGS,0.0,201.33,0.0
2021-06-15,Transfer,8323.71,0.0,8323.71
2021-06-15,Cash,0.0,832.37,7491.34
2021-06-15,Bill,0.0,1498.27,5993.07
2021-06-15,Miscellaneous,0.0,5993.07,0.0
2021-06-15,RTGS,888.19,0.0,888.19
2021-06-15,NEFT,0.0,98.69,789.5
2021-06-15,Miscellaneous,97.19,0.0,886.69
2021-06-15,IMPS,0.0,886.69,0.0
2021-06-15,Interest,78222.0,0.0,78222.0
2021-06-15,ATM,0.0,7822.2,70399.8
2021-06-15,IMPS,445.1,0.0,70844.9
2021-06-16,Commission,507763.0,0.0,578607.9
2021-06-16,Interest,16421.0,0.0,595028.9
2021-06-16,Cash,16.0,0.0,595044.9
2021-06-16,Cheque,4.3,0.0,595049.2
2021-06-16,Commission,31791.8,0.0,626841.0
2021-06-16,NEFT,0.0,125368.2,501472.8
2021-06-16,Interest,2.0,0.0,501474.8
2021-06-16,Cheque,21.0,0.0,501495.8
2021-06-16,IMPS,0.0,250747.9,250747.9
2021-06-16,Reversal,0.0,250747.9,0.0
2021-06-16,Commission,6.4,0.0,6.4
2021-06-16,Tax,0.0,0.64,5.76
2021-06-16,Tax,0.0,1.15,4.61
2021-06-16,Debit Card,428.0,0.0,432.61
2021-06-16,Miscellaneous,0.0,144.2,288.41
2021-06-16,Transfer,428.0,0.0,716.41
2021-06-16,Commission,5.6,0.0,722.01
2021-06-16,Cheque,0.0,240.67,481.34
2021-06-16,Debit Card,0.0,68.76,412.58
2021-06-16,Tax,113.0,0.0,525.58
2021-06-16,Reversal,0.0,131.4,394.19
2021-06-16,Transfer,6.65,0.0,400.84
2021-06-16,Debit Card,0.0,44.54,356.3
2021-06-16,Commission,0.0,44.54,311.76
2021-06-16,Commission,0.0,38.97,272.79
2021-06-16,Tax,1909368.8,0.0,1909641.59
2021-06-17,IMPS,0.0,0.0,1909641.59
2021-06-18,ATM,1196974.0,0.0,3106615.59
2021-06-18,Tax,0.0,443802.23,2662813.36
2021-06-19,Transfer,26446.0,0.0,2689259.36
2021-06-19,Reversal,1.0,0.0,2689260.36
2021-06-19,NEFT,29470.3,0.0,2718730.66
2021-06-19,NEFT,0.0,339841.33,2378889.33
2021-06-19,Cash,0.0,297361.17,2081528.16
2021-06-19,Purchase,0.0,297361.17,1784166.99
2021-06-19,Commission,0.0,446041.75,1338125.24
2021-06-19,Purchase,7025.3,0.0,1345150.54
2021-06-19,IMPS,8.84,0.0,1345159.38
2021-06-19,Miscellaneous,55.49,0.0,1345214.87
2021-06-19,RTGS,0.0,192173.55,1153041.32
2021-06-19,NEFT,0.0,576520.66,576520.66
2021-06-19,Transfer,0.0,115304.13,461216.53
2021-06-19,ATM,175.0,0.0,461391.53
2021-06-19,Debit Card,0.0,153797.18,307594.35
2021-06-20,NEFT,10.71,0.0,307605.06
2021-06-20,Purchase,2.0,0.0,307607.06
2021-06-20,IMPS,7.5,0.0,307614.56
2021-06-20,Tax,0.0,76903.64,230710.92
2021-06-20,Debit Card,395.2,0.0,231106.12
2021-06-20,Interest,0.0,115553.06,115553.06
2021-06-20,Miscellaneous,0.0,38517.69,77035.37
2021-06-20,ATM,1561.5,0.0,78596.87
2021-06-20,Interest,0.0,7859.69,70737.18
2021-06-20,IMPS,0.0,7073.72,63663.46
2021-06-20,Cash,1977444.0,0.0,2041107.46
2021-06-20,Bill,0.0,510276.87,1530830.6
2021-06-20,Purchase,169470.0,0.0,1700300.6
2021-06-20,Miscellaneous,0.0,566766.87,1133533.73
2021-06-20,Interest,0.0,161933.39,971600.34
2021-06-20,Debit Card,0.0,97160.03,874440.31
2021-06-20,ATM,122.8,0.0,874563.11
2021-06-20,Commission,0.0,874563.11,0.0
2021-06-21,Interest,56.26,0.0,56.26
2021-06-21,Miscellaneous,0.0,9.38,46.88
2021-06-21,NEFT,0.0,46.88,0.0
2021-06-21,ATM,593.0,0.0,593.0
2021-06-21,Interest,1.11,0.0,594.11
2021-06-21,Cash,12531.0,0.0,13125.11
2021-06-21,ATM,0.0,1312.51,11812.6
2021-06-21,Debit Card,197781.0,0.0,209593.6
2021-06-21,Transfer,0.0,20959.36,188634.24
2021-06-21,Interest,0.0,20959.36,167674.88
2021-06-21,Cash,2454.4,0.0,170129.28
2021-06-21,RTGS,51.69,0.0,170180.97
2021-06-21,IMPS,1387274.5,0.0,1557455.47
2021-06-21,Tax,0.0,155745.55,1401709.92
2021-06-21,Cash,1.9,0.0,1401711.82
2021-06-22,Miscellaneous,0.0,200244.55,1201467.27
2021-06-22,IMPS,2866.82,0.0,1204334.09
2021-06-22,RTGS,0.0,200722.35,1003611.74
2021-06-22,Cash,0.0,1003611.74,0.0
2021-06-22,Reversal,69708.34,0.0,69708.34
2021-06-22,ATM,585696.5,0.0,655404.84
2021-06-22,Miscellaneous,0.0,131080.97,524323.87
2021-06-22,Reversal,17502.4,0.0,541826.27
2021-06-22,Reversal,16.1,0.0,541842.37
2021-06-22,Transfer,3258.9,0.0,545101.27
2021-06-23,Bill,920.8,0.0,546022.07
2021-06-23,Commission,0.0,136505.52,409516.55
2021-06-23,Commission,0.0,45501.84,364014.71
2021-06-23,IMPS,0.0,91003.68,273011.03
2021-06-23,Cash,0.0,136505.52,136505.52
2021-06-23,Tax,0.0,22750.92,113754.6
2021-06-23,Miscellaneous,333.61,0.0,114088.21
2021-06-23,Bill,0.0,38029.4,76058.81
2021-06-23,Transfer,2261.38,0.0,78320.19
2021-06-23,RTGS,30531.9,0.0,108852.09
2021-06-23,Reversal,58.8,0.0,108910.89
2021-06-23,Interest,0.0,21782.18,87128.71
2021-06-23,RTGS,2.9,0.0,87131.61
2021-06-23,RTGS,4.0,0.0,87135.61
2021-06-23,RTGS,0.0,0.0,87135.61
2021-06-23,Commission,8517.6,0.0,95653.21
2021-06-23,Interest,0.0,15942.2,79711.01
2021-06-24,Purchase,139.29,0.0,79850.3
2021-06-24,Transfer,7.0,0.0,79857.3
2021-06-24,Transfer,0.0,13309.55,66547.75
2021-06-24,Miscellaneous,0.0,8318.47,58229.28
2021-06-24,Reversal,0.0,14557.32,43671.96
2021-06-24,Miscellaneous,0.0,5459.0,38212.96
2021-06-24,Interest,0.0,9553.24,28659.72
2021-06-24,Cheque,0.0,4776.62,23883.1
2021-06-24,IMPS,88.93,0.0,23972.03
2021-06-24,IMPS,146.2,0.0,24118.23
2021-06-24,Interest,0.0,4019.71,20098.53
2021-06-24,Bill,0.0,10049.27,10049.26
2021-06-24,Miscellaneous,0.0,1116.58,8932.68
2021-06-24,ATM,0.0,1488.78,7443.9
2021-06-25,Tax,0.0,2481.3,4962.6
2021-06-25,Tax,4090.6,0.0,9053.2
2021-06-25,RTGS,5.44,0.0,9058.64
2021-06-25,ATM,0.0,1509.77,7548.87
2021-06-25,Commission,32518.23,0.0,40067.1
2021-06-25,Commission,0.0,4451.9,35615.2
2021-06-25,Reversal,456296.0,0.0,491911.2
2021-06-26,Debit Card,0.0,98382.24,393528.96
2021-06-26,Debit Card,0.0,43725.44,349803.52
2021-06-26,IMPS,2764.2,0.0,352567.72
2021-06-26,Commission,2715.3,0.0,355283.02
2021-06-26,NEFT,0.0,88820.76,266462.26
2021-06-26,Cash,834916.0,0.0,1101378.26
2021-06-26,Miscellaneous,113116.2,0.0,1214494.46
2021-06-26,Debit Card,0.0,303623.62,910870.84
2021-06-26,Transfer,0.0,130124.41,780746.43
2021-06-26,Transfer,15835.0,0.0,796581.43
2021-06-26,Debit Card,0.0,132763.57,663817.86
2021-06-26,Cash,7.4,0.0,663825.26
2021-06-26,Cash,243.0,0.0,664068.26
2021-06-26,Miscellaneous,326.48,0.0,664394.74
2021-06-26,Tax,0.0,132878.95,531515.79
2021-06-26,Cash,0.0,132878.95,398636.84
2021-06-26,RTGS,0.0,79727.37,318909.47
2021-06-26,ATM,307.8,0.0,319217.27
2021-06-26,IMPS,0.11,0.0,319217.38
2021-06-26,Tax,99.0,0.0,319316.38
2021-06-26,Commission,0.0,31931.64,287384.74
2021-06-26,Debit Card,0.0,31931.64,255453.1
2021-06-27,Transfer,97.08,0.0,255550.18
2021-06-27,Commission,1539402.0,0.0,1794952.18
2021-06-27,Debit Card,1450597.8,0.0,3245549.98
2021-06-27,Cheque,0.0,324555.0,2920994.98
2021-06-27,Purchase,230.0,0.0,2921224.98
2021-06-27,ATM,22.8,0.0,2921247.78
2021-06-27,Interest,701.42,0.0,2921949.2
2021-06-28,Reversal,0.0,973983.07,1947966.13
2021-06-28,Debit Card,0.0,243495.77,1704470.36
2021-06-28,RTGS,0.0,852235.18,852235.18
2021-06-28,Cheque,0.0,284078.39,568156.79
2021-06-28,ATM,0.0,113631.36,454525.43
2021-06-28,Tax,0.0,64932.2,389593.23
2021-06-28,Reversal,0.0,129864.41,259728.82
2021-06-28,Transfer,42.0,0.0,259770.82
2021-06-28,IMPS,174008.0,0.0,433778.82
2021-06-28,RTGS,0.0,144592.94,289185.88
2021-06-28,Reversal,0.0,57837.18,231348.7
2021-06-28,Purchase,24.5,0.0,231373.2
2021-06-28,IMPS,0.0,57843.3,173529.9
2021-06-28,Tax,173746.91,0.0,347276.81
2021-06-28,Interest,0.0,86819.2,260457.61
2021-06-28,IMPS,0.0,86819.2,173638.41
2021-06-28,Reversal,25992.29,0.0,199630.7
2021-06-28,Tax,0.0,22181.19,177449.51
2021-06-28,Commission,3679.0,0.0,181128.51
2021-06-28,Cheque,3.94,0.0,181132.45
2021-06-28,Purchase,15.03,0.0,181147.48
2021-06-28,Reversal,0.0,22643.44,158504.05
2021-06-28,Debit Card,65875.0,0.0,224379.05
2021-06-28,Transfer,1898.7,0.0,226277.75
2021-06-28,NEFT,0.0,28284.72,197993.03
2021-06-28,Commission,0.0,28284.72,169708.31
2021-06-28,Debit Card,3494.07,0.0,173202.38
2021-06-28,RTGS,9630.0,0.0,182832.38
2021-06-28,Cheque,0.0,22854.05,159978.33
2021-06-28,Miscellaneous,10705.6,0.0,170683.93
2021-06-28,Commission,4541.2,0.0,175225.13
2021-06-28,NEFT,0.0,43806.28,131418.85
2021-06-28,IMPS,32472.98,0.0,163891.83
2021-06-28,Cheque,3207.0,0.0,167098.83
2021-06-28,ATM,0.0,16709.88,150388.95
2021-06-28,Bill,0.0,18798.62,131590.33
2021-06-28,RTGS,3279.17,0.0,134869.5
2021-06-28,Tax,0.0,44956.5,89913.0
2021-06-28,RTGS,0.0,29971.0,59942.0
2021-06-28,Reversal,0.0,7492.75,52449.25
2021-06-28,IMPS,664.0,0.0,53113.25
2021-06-28,Commission,1169164.0,0.0,1222277.25
2021-06-28,RTGS,16.0,0.0,1222293.25
2021-06-28,Reversal,0.0,1222293.25,0.0
2021-06-29,Bill,3004.72,0.0,3004.72
2021-06-29,Cheque,0.0,500.79,2503.93
2021-06-29,NEFT,0.0,1251.97,1251.96
2021-06-29,Tax,0.0,1251.96,0.0
2021-06-29,Bill,372.0,0.0,372.0
2021-06-30,Interest,168254.28,0.0,168626.28
2021-06-30,Tax,393.7,0.0,169019.98
2021-06-30,Tax,0.0,28170.0,140849.98
2021-06-30,RTGS,0.0,14085.0,126764.98
2021-06-30,Purchase,206.58,0.0,126971.56
2021-06-30,Purchase,21905.7,0.0,148877.26
2021-06-30,Interest,0.0,37219.32,111657.94
2021-06-30,Reversal,0.0,37219.31,74438.63
2021-06-30,Reversal,0.0,7443.86,66994.77
2021-06-30,Interest,504.0,0.0,67498.77
2021-06-30,Reversal,9.7,0.0,67508.47
2021-06-30,IMPS,19.0,0.0,67527.47
2021-06-30,Tax,0.0,16881.87,50645.6
2021-06-30,Miscellaneous,6.2,0.0,50651.8
2021-06-30,Purchase,3659.5,0.0,54311.3
2021-06-30,Transfer,54.1,0.0,54365.4
2021-06-30,IMPS,275.0,0.0,54640.4
2021-06-30,Miscellaneous,1175792.0,0.0,1230432.4
2021-06-30,Cash,41.55,0.0,1230473.95
2021-06-30,Commission,0.0,175781.99,1054691.96
2021-06-30,Debit Card,0.0,351563.99,703127.97
2021-06-30,IMPS,0.0,87891.0,615236.97
2021-06-30,Tax,1463.0,0.0,616699.97
2021-06-30,Debit Card,0.0,205566.66,411133.31
2021-06-30,Tax,0.0,45681.48,365451.83
2021-06-30,Interest,0.0,73090.37,292361.46
2021-06-30,Bill,1165.0,0.0,293526.46
2021-06-30,Purchase,546503.5,0.0,840029.96
2021-06-30,ATM,2010311.2,0.0,2850341.16
2021-06-30,Interest,1138.03,0.0,2851479.19
2021-07-01,Cheque,137955.0,0.0,2989434.19
2021-07-01,Commission,12.1,0.0,2989446.29
2021-07-01,RTGS,36.0,0.0,2989482.29
2021-07-01,Reversal,1499228.0,0.0,4488710.29
2021-07-01,Miscellaneous,0.0,748118.38,3740591.91
2021-07-01,Interest,0.0,534370.27,3206221.64
2021-07-01,Cheque,0.0,356246.85,2849974.79
2021-07-01,Bill,1224.9,0.0,2851199.69
2021-07-01,Commission,0.0,570239.94,2280959.75
2021-07-01,Bill,0.0,253439.97,2027519.78
2021-07-01,Commission,0.0,405503.96,1622015.82
2021-07-01,IMPS,450.1,0.0,1622465.92
2021-07-01,Debit Card,422.7,0.0,1622888.62
2021-07-01,Tax,231.78,0.0,1623120.4
2021-07-01,IMPS,758675.25,0.0,2381795.65
2021-07-01,RTGS,12.0,0.0,2381807.65
2021-07-01,NEFT,0.0,396967.94,1984839.71
2021-07-01,RTGS,1264366.5,0.0,3249206.21
2021-07-01,Commission,3324.0,0.0,3252530.21
2021-07-01,IMPS,1206728.0,0.0,4459258.21
2021-07-01,NEFT,0.0,557407.28,3901850.93
2021-07-01,Commission,24372.0,0.0,3926222.93
2021-07-01,Reversal,19.7,0.0,3926242.63
2021-07-01,ATM,40.0,0.0,3926282.63
2021-07-01,Debit Card,1057.0,0.0,3927339.63
2021-07-01,Bill,0.0,3927339.63,0.0
2021-07-01,Reversal,29265.0,0.0,29265.0
2021-07-01,Cash,23648.97,0.0,52913.97
2021-07-01,Bill,0.0,5291.4,47622.57
2021-07-01,Miscellaneous,5.78,0.0,47628.35
2021-07-01,Interest,0.0,6804.05,40824.3
2021-07-01,Miscellaneous,0.0,10206.08,30618.22
2021-07-01,NEFT,0.0,6123.64,24494.58
2021-07-01,IMPS,1949978.0,0.0,1974472.58
2021-07-01,Commission,0.0,493618.15,1480854.44
2021-07-01,Debit Card,0.0,296170.89,1184683.55
2021-07-01,Bill,0.0,118468.36,1066215.2
2021-07-01,Debit Card,3557.0,0.0,1069772.2
2021-07-01,ATM,0.0,133721.53,936050.68
2021-07-01,Transfer,0.08,0.0,936050.76
2021-07-01,Commission,0.0,234012.69,702038.07
2021-07-01,IMPS,30.8,0.0,702068.87
2021-07-01,RTGS,79.0,0.0,702147.87
2021-07-01,Tax,0.0,234049.29,468098.58
2021-07-01,Cheque,322.42,0.0,468421.0
2021-07-01,Interest,7.3,0.0,468428.3
2021-07-01,Reversal,9.9,0.0,468438.2
2021-07-01,Cheque,0.0,66919.74,401518.46
2021-07-01,Debit Card,0.0,0.0,401518.46
2021-07-01,Tax,0.0,401518.46,0.0
2021-07-01,Cheque,2.9,0.0,2.9
2021-07-01,ATM,0.0,0.36,2.54
2021-07-02,Transfer,6.0,0.0,8.54
2021-07-02,NEFT,1753186.0,0.0,1753194.54
2021-07-02,Bill,0.0,584398.18,1168796.36
2021-07-02,Reversal,0.0,233759.27,935037.09
2021-07-02,Miscellaneous,409086.8,0.0,1344123.89
2021-07-02,IMPS,0.0,672061.95,672061.94
2021-07-02,Debit Card,782036.2,0.0,1454098.14
2021-07-02,Debit Card,7.3,0.0,1454105.44
2021-07-02,Bill,0.0,181763.18,1272342.26
2021-07-02,RTGS,227630.9,0.0,1499973.16
2021-07-02,Cash,0.0,299994.63,1199978.53
2021-07-02,Bill,0.0,599989.27,599989.26
2021-07-02,Cheque,0.0,85712.75,514276.51
2021-07-02,Commission,0.0,73468.07,440808.44
2021-07-02,IMPS,0.0,48978.72,391829.72
2021-07-02,NEFT,6.66,0.0,391836.38
2021-07-02,RTGS,0.0,48979.55,342856.83
2021-07-02,Cash,251.07,0.0,343107.9
2021-07-02,Tax,238020.0,0.0,581127.9
2021-07-02,Bill,0.0,116225.58,464902.32
2021-07-02,Bill,274.69,0.0,465177.01
2021-07-02,Commission,0.0,51686.33,413490.68
2021-07-02,Purchase,0.0,59070.1,354420.58
2021-07-02,Purchase,31326.03,0.0,385746.61
2021-07-02,IMPS,0.0,48218.33,337528.28
2021-07-02,Cash,907043.5,0.0,1244571.78
2021-07-02,Miscellaneous,6.6,0.0,1244578.38
2021-07-02,RTGS,0.0,311144.6,933433.78
2021-07-02,Transfer,0.0,933433.78,0.0
2021-07-02,ATM,53.0,0.0,53.0
2021-07-02,Cheque,3776.5,0.0,3829.5
2021-07-02,ATM,31310.0,0.0,35139.5
2021-07-02,ATM,0.0,5856.58,29282.92
2021-07-03,Transfer,0.0,4183.27,25099.65
2021-07-03,Transfer,212541.0,0.0,237640.65
2021-07-03,Cheque,0.0,118820.33,118820.32
2021-07-03,Miscellaneous,0.0,11882.03,106938.29
2021-07-03,Debit Card,11614.0,0.0,118552.29
2021-07-03,NEFT,0.5,0.0,118552.79
2021-07-03,Interest,0.0,14819.1,103733.69
2021-07-03,IMPS,0.0,25933.42,77800.27
2021-07-03,Miscellaneous,1839.4,0.0,79639.67
2021-07-03,Transfer,0.0,79639.67,0.0
2021-07-03,Purchase,969625.0,0.0,969625.0
2021-07-03,ATM,27557.4,0.0,997182.4
2021-07-03,Cheque,15.7,0.0,997198.1
2021-07-03,Reversal,0.0,142456.87,854741.23
2021-07-03,Reversal,0.0,142456.87,712284.36
2021-07-03,NEFT,0.0,101754.91,610529.45
2021-07-03,NEFT,0.0,203509.82,407019.63
2021-07-03,ATM,0.0,407019.63,0.0
2021-07-04,Debit Card,56271.0,0.0,56271.0
2021-07-04,Miscellaneous,244836.34,0.0,301107.34
2021-07-04,Tax,4.86,0.0,301112.2
2021-07-04,Commission,0.0,37639.03,263473.18
2021-07-05,Bill,0.0,37639.03,225834.15
2021-07-05,Interest,1.02,0.0,225835.17
2021-07-05,IMPS,0.0,28229.4,197605.77
2021-07-05,NEFT,0.0,49401.44,148204.33
2021-07-05,Purchase,3681.0,0.0,151885.33
2021-07-05,Bill,33.37,0.0,151918.7
2021-07-05,Reversal,0.0,18989.84,132928.86
2021-07-05,IMPS,0.0,44309.62,88619.24
2021-07-05,Debit Card,26897.0,0.0,115516.24
2021-07-06,Interest,0.0,14439.53,101076.71
2021-07-06,Tax,0.0,101076.71,0.0
2021-07-06,Miscellaneous,3004.0,0.0,3004.0
2021-07-06,Purchase,1520.0,0.0,4524.0
2021-07-06,Commission,0.0,2262.0,2262.0
2021-07-07,Interest,1699.9,0.0,3961.9
2021-07-07,Miscellaneous,1481732.2,0.0,1485694.1
2021-07-07,Transfer,0.0,148569.41,1337124.69
2021-07-07,Purchase,2647.3,0.0,1339771.99
2021-07-07,Cheque,0.0,446590.66,893181.33
2021-07-07,NEFT,0.0,446590.67,446590.66
2021-07-07,IMPS,63.0,0.0,446653.66
2021-07-07,Cash,2975.73,0.0,449629.39
2021-07-07,Reversal,20.56,0.0,449649.95
2021-07-07,Debit Card,0.0,64235.71,385414.24
2021-07-07,Reversal,0.0,128471.41,256942.83
2021-07-07,Interest,0.0,64235.71,192707.12
2021-07-07,RTGS,222967.7,0.0,415674.82
2021-07-07,Tax,0.0,41567.48,374107.34
2021-07-07,NEFT,1129895.0,0.0,1504002.34
2021-07-07,Purchase,0.0,501334.11,1002668.23
2021-07-07,Interest,0.0,143238.32,859429.91
2021-07-07,Cheque,32266.03,0.0,891695.94
2021-07-07,Interest,0.0,891695.94,0.0
2021-07-07,Miscellaneous,2087.0,0.0,2087.0
2021-07-07,IMPS,1364436.0,0.0,1366523.0
2021-07-07,Bill,18120.0,0.0,1384643.0
2021-07-07,Reversal,0.0,1384643.0,0.0
2021-07-07,Tax,25.6,0.0,25.6
2021-07-07,Cash,0.0,3.66,21.94
2021-07-07,Commission,469.1,0.0,491.04
2021-07-07,Commission,69.8,0.0,560.84
2021-07-07,IMPS,26162.5,0.0,26723.34
2021-07-08,Cheque,1247850.0,0.0,1274573.34
2021-07-08,Transfer,0.0,159321.67,1115251.67
2021-07-08,Cheque,3578.8,0.0,1118830.47
2021-07-08,IMPS,0.0,139853.81,978976.66
2021-07-08,Transfer,0.0,978976.66,0.0
2021-07-08,Reversal,3.9,0.0,3.9
2021-07-09,Bill,3.0,0.0,6.9
2021-07-09,Transfer,0.0,1.73,5.18
2021-07-09,Bill,0.0,0.52,4.66
2021-07-09,Miscellaneous,0.0,0.67,3.99
2021-07-09,Miscellaneous,0.0,0.8,3.19
2021-07-09,RTGS,179596.75,0.0,179599.94
2021-07-09,Reversal,0.0,25657.13,153942.81
2021-07-09,Miscellaneous,0.0,25657.14,128285.68
2021-07-09,Reversal,26946.3,0.0,155231.98
2021-07-09,Bill,304.0,0.0,155535.98
2021-07-09,Commission,0.0,155535.98,0.0
2021-07-09,Tax,162.0,0.0,162.0
2021-07-09,Commission,0.0,20.25,141.75
2021-07-09,Debit Card,0.0,47.25,94.5
2021-07-09,Commission,306.0,0.0,400.5
2021-07-09,Transfer,39.0,0.0,439.5
2021-07-09,Purchase,0.0,439.5,0.0
2021-07-09,Commission,330.7,0.0,330.7
2021-07-10,Debit Card,0.0,36.74,293.96
2021-07-10,Commission,13686.18,0.0,13980.14
2021-07-10,IMPS,0.0,2330.02,11650.12
2021-07-10,Reversal,0.0,2330.02,9320.1
2021-07-10,Bill,0.0,4660.05,4660.05
2021-07-10,Debit Card,124.0,0.0,4784.05
2021-07-10,Reversal,41.7,0.0,4825.75
2021-07-10,Tax,0.0,965.15,3860.6
2021-07-10,Transfer,0.0,1930.3,1930.3
2021-07-10,Debit Card,21994.8,0.0,23925.1
2021-07-10,IMPS,215.2,0.0,24140.3
2021-07-10,ATM,0.0,6035.08,18105.22
2021-07-10,Purchase,240.0,0.0,18345.22
2021-07-10,Miscellaneous,228646.53,0.0,246991.75
2021-07-10,IMPS,149966.75,0.0,396958.5
2021-07-10,RTGS,0.0,198479.25,198479.25
2021-07-10,NEFT,1223.42,0.0,199702.67
2021-07-10,Interest,184919.0,0.0,384621.67
2021-07-10,Transfer,0.0,48077.71,336543.96
2021-07-10,Cheque,0.0,48077.71,288466.25
2021-07-10,Miscellaneous,0.0,288466.25,0.0
2021-07-10,Transfer,72.1,0.0,72.1
2021-07-10,Tax,2033004.0,0.0,2033076.1
2021-07-10,Tax,0.0,1016538.05,1016538.05
2021-07-10,Transfer,22906.0,0.0,1039444.05
2021-07-10,Transfer,1950845.2,0.0,2990289.25
2021-07-10,Purchase,0.0,747572.31,2242716.94
2021-07-10,Purchase,0.0,373786.16,1868930.78
2021-07-10,Purchase,0.0,622976.93,1245953.85
2021-07-10,IMPS,0.0,124595.39,1121358.47
2021-07-10,Reversal,0.0,373786.16,747572.31
2021-07-10,Cheque,1176.1,0.0,748748.41
2021-07-10,RTGS,1.0,0.0,748749.41
2021-07-10,RTGS,0.0,93593.68,655155.73
2021-07-10,Tax,7608.2,0.0,662763.93
2021-07-10,Cheque,0.0,132552.79,530211.14
2021-07-10,ATM,0.0,265105.57,265105.57
2021-07-10,Debit Card,199.2,0.0,265304.77
2021-07-10,Debit Card,0.0,132652.39,132652.38
2021-07-10,Bill,0.0,26530.48,106121.9
2021-07-10,Debit Card,0.0,17686.98,88434.92
2021-07-10,Miscellaneous,764.14,0.0,89199.06
2021-07-10,ATM,6.1,0.0,89205.16
2021-07-10,NEFT,0.0,12743.59,76461.57
2021-07-10,Debit Card,1.0,0.0,76462.57
2021-07-10,Commission,0.0,8495.84,67966.73
2021-07-10,Miscellaneous,0.0,13593.35,54373.38
2021-07-10,Tax,25607.15,0.0,79980.53
2021-07-10,Miscellaneous,3856.7,0.0,83837.23
2021-07-10,RTGS,12264.0,0.0,96101.23
2021-07-10,ATM,0.0,19220.25,76880.98
2021-07-10,Transfer,0.0,25626.99,51253.99
2021-07-10,Interest,0.0,17084.66,34169.33
2021-07-10,Cheque,0.0,34169.33,0.0
2021-07-10,Cheque,926276.0,0.0,926276.0
2021-07-10,Tax,26233.0,0.0,952509.0
2021-07-10,Commission,0.0,190501.8,762007.2
2021-07-10,RTGS,0.0,127001.2,635006.0
2021-07-10,Debit Card,185135.0,0.0,820141.0
2021-07-10,RTGS,0.0,410070.5,410070.5
2021-07-10,Interest,0.0,82014.1,328056.4
2021-07-10,Reversal,1760280.2,0.0,2088336.6
2021-07-10,RTGS,0.0,417667.32,1670669.28
2021-07-10,Cash,0.0,835334.64,835334.64
2021-07-10,Cheque,45755.4,0.0,881090.04
2021-07-10,Cash,1.4,0.0,881091.44
2021-07-10,Purchase,2960.95,0.0,884052.39
2021-07-10,Transfer,6.0,0.0,884058.39
2021-07-10,Miscellaneous,0.0,442029.2,442029.2
2021-07-10,RTGS,0.0,110507.3,331521.9
2021-07-10,IMPS,74486.0,0.0,406007.9
2021-07-10,Reversal,3599.4,0.0,409607.3
2021-07-10,NEFT,0.0,102401.83,307205.47
2021-07-10,ATM,271.0,0.0,307476.47
2021-07-10,NEFT,0.0,43925.21,263551.26
2021-07-10,ATM,0.0,43925.21,219626.05
2021-07-10,Bill,268.59,0.0,219894.64
2021-07-10,ATM,0.0,24432.74,195461.9
2021-07-10,ATM,372.0,0.0,195833.9
2021-07-10,IMPS,1.0,0.0,195834.9
2021-07-10,ATM,0.0,97917.45,97917.45
2021-07-10,Reversal,0.0,32639.15,65278.3
2021-07-10,RTGS,104538.0,0.0,169816.3
2021-07-10,Cheque,2067.92,0.0,171884.22
2021-07-10,Cheque,0.0,17188.42,154695.8
2021-07-10,Reversal,0.0,77347.9,77347.9
2021-07-10,Interest,32412.4,0.0,109760.3
2021-07-10,IMPS,2.04,0.0,109762.34
2021-07-10,Miscellaneous,75037.5,0.0,184799.84
2021-07-10,Commission,7.02,0.0,184806.86
2021-07-10,Cash,0.0,23100.86,161706.0
2021-07-10,Tax,301.2,0.0,162007.2
2021-07-10,Cheque,0.0,18000.8,144006.4
2021-07-10,Cash,20310.03,0.0,164316.43
2021-07-10,Transfer,31.0,0.0,164347.43
2021-07-10,Bill,0.67,0.0,164348.1
2021-07-10,Interest,3283.6,0.0,167631.7
2021-07-10,RTGS,0.0,27938.62,139693.08
2021-07-10,Commission,0.0,15521.45,124171.63
2021-07-10,IMPS,9.64,0.0,124181.27
2021-07-10,Purchase,0.0,62090.64,62090.64
2021-07-10,Miscellaneous,47.72,0.0,62138.36
2021-07-10,ATM,0.0,6213.84,55924.52
2021-07-10,Debit Card,17143.81,0.0,73068.33
2021-07-11,Debit Card,0.0,18267.08,54801.25
2021-07-11,Interest,1965.9,0.0,56767.15
2021-07-11,Cash,3374.47,0.0,60141.62
2021-07-11,Commission,1606310.75,0.0,1666452.37
2021-07-11,Bill,37.14,0.0,1666489.51
2021-07-11,Transfer,0.0,277748.25,1388741.26
2021-07-11,Commission,4412.0,0.0,1393153.26
2021-07-11,NEFT,0.0,174144.16,1219009.1
2021-07-11,Miscellaneous,3.8,0.0,1219012.9
2021-07-11,Tax,22.5,0.0,1219035.4
2021-07-11,Cash,692905.0,0.0,1911940.4
2021-07-11,Miscellaneous,0.0,637313.47,1274626.93
2021-07-11,Tax,1831898.0,0.0,3106524.93
2021-07-11,ATM,591.94,0.0,3107116.87
2021-07-11,RTGS,0.0,776779.22,2330337.65
2021-07-11,Cash,0.0,776779.22,1553558.43
2021-07-11,ATM,0.0,517852.81,1035705.62
2021-07-11,Tax,0.0,129463.2,906242.42
2021-07-11,Cheque,0.0,453121.21,453121.21
2021-07-11,Reversal,0.0,56640.15,396481.06
2021-07-11,Cash,353456.5,0.0,749937.56
2021-07-11,Bill,0.0,187484.39,562453.17
2021-07-11,IMPS,0.0,56245.32,506207.85
2021-07-11,Cash,5.9,0.0,506213.75
2021-07-12,ATM,24194.18,0.0,530407.93
2021-07-12,NEFT,0.0,75772.56,454635.37
2021-07-12,Debit Card,140.0,0.0,454775.37
2021-07-12,Miscellaneous,0.0,90955.07,363820.3
2021-07-12,Commission,0.0,40424.48,323395.82
2021-07-12,NEFT,14900.72,0.0,338296.54
2021-07-12,Purchase,0.0,42287.07,296009.47
2021-07-12,NEFT,0.0,148004.74,148004.73
2021-07-12,RTGS,1917.57,0.0,149922.3
2021-07-12,ATM,0.0,14992.23,134930.07
2021-07-12,IMPS,12121.4,0.0,147051.47
2021-07-12,Commission,0.0,14705.15,132346.32
2021-07-12,Miscellaneous,27.9,0.0,132374.22
2021-07-12,Commission,0.0,18910.6,113463.62
2021-07-12,Purchase,14119.34,0.0,127582.96
2021-07-12,ATM,5.0,0.0,127587.96
2021-07-12,Commission,349.26,0.0,127937.22
2021-07-12,Tax,17794.9,0.0,145732.12
2021-07-12,Commission,32554.0,0.0,178286.12
2021-07-12,Cash,0.0,59428.71,118857.41
2021-07-12,NEFT,0.0,13206.38,105651.03
2021-07-12,Commission,3154.2,0.0,108805.23
2021-07-12,Cheque,0.0,27201.31,81603.92
2021-07-12,Interest,1292183.8,0.0,1373787.72
2021-07-12,NEFT,225657.69,0.0,1599445.41
2021-07-13,Miscellaneous,3197.43,0.0,1602642.84
2021-07-13,Miscellaneous,0.0,160264.28,1442378.56
2021-07-13,Commission,0.0,480792.85,961585.71
2021-07-13,RTGS,0.0,320528.57,641057.14
2021-07-13,ATM,0.0,106842.86,534214.28
2021-07-13,Debit Card,202184.0,0.0,736398.28
2021-07-13,Bill,461.0,0.0,736859.28
2021-07-13,ATM,5.88,0.0,736865.16
2021-07-13,Bill,4670.05,0.0,741535.21
2021-07-14,NEFT,1748333.0,0.0,2489868.21
2021-07-14,RTGS,1199.0,0.0,2491067.21
2021-07-14,Cash,225868.0,0.0,2716935.21
2021-07-14,NEFT,1.0,0.0,2716936.21
2021-07-14,Transfer,126791.0,0.0,2843727.21
2021-07-14,Reversal,0.0,710931.8,2132795.41
2021-07-14,Transfer,0.0,710931.8,1421863.61
2021-07-14,Cash,0.0,355465.9,1066397.71
2021-07-14,Interest,0.0,1066397.71,0.0
2021-07-14,Miscellaneous,8919.0,0.0,8919.0
2021-07-14,IMPS,0.0,2229.75,6689.25
2021-07-14,Cash,0.4,0.0,6689.65
2021-07-14,Cheque,0.0,1672.41,5017.24
2021-07-14,Commission,143.0,0.0,5160.24
2021-07-14,Bill,0.0,645.03,4515.21
2021-07-14,Purchase,0.0,752.54,3762.68
2021-07-14,Cash,71.0,0.0,3833.68
2021-07-15,ATM,48964.0,0.0,52797.68
2021-07-16,Bill,21058.2,0.0,73855.88
2021-07-16,IMPS,0.0,9231.99,64623.9
2021-07-16,ATM,0.0,10770.65,53853.25
2021-07-16,Miscellaneous,0.0,53853.25,0.0
2021-07-16,Transfer,297.7,0.0,297.7
2021-07-16,NEFT,430.78,0.0,728.48
2021-07-16,Tax,0.0,80.94,647.54
2021-07-16,IMPS,58.5,0.0,706.04
2021-07-16,Miscellaneous,383.0,0.0,1089.04
2021-07-16,Cheque,0.0,363.01,726.03
2021-07-16,ATM,0.0,121.01,605.02
2021-07-16,Miscellaneous,1297.0,0.0,1902.02
2021-07-16,RTGS,0.0,317.0,1585.02
2021-07-16,ATM,0.0,176.11,1408.91
2021-07-16,Transfer,0.0,469.64,939.27
2021-07-16,Interest,4.0,0.0,943.27
2021-07-16,ATM,0.0,943.27,0.0
2021-07-16,Tax,43.8,0.0,43.8
2021-07-16,Cash,7.6,0.0,51.4
2021-07-16,Commission,0.0,25.7,25.7
2021-07-16,Bill,0.0,4.28,21.42
2021-07-16,Debit Card,476225.2,0.0,476246.62
2021-07-16,RTGS,2551.0,0.0,478797.62
2021-07-16,Transfer,144862.0,0.0,623659.62
2021-07-16,Bill,354956.0,0.0,978615.62
2021-07-16,Bill,0.0,244653.91,733961.72
2021-07-16,IMPS,1439622.0,0.0,2173583.72
2021-07-16,Miscellaneous,38.7,0.0,2173622.42
2021-07-16,Cheque,0.0,217362.24,1956260.18
2021-07-16,Cheque,41.0,0.0,1956301.18
2021-07-16,Transfer,4.1,0.0,1956305.28
2021-07-16,Cheque,28224.8,0.0,1984530.08
2021-07-16,RTGS,0.0,198453.01,1786077.07
2021-07-16,Interest,0.0,178607.71,1607469.36
2021-07-17,Bill,1952380.0,0.0,3559849.36
2021-07-17,Commission,0.0,1186616.45,2373232.91
2021-07-17,Cheque,0.0,1186616.46,1186616.46
2021-07-17,RTGS,0.0,169516.64,1017099.82
2021-07-17,Transfer,0.0,127137.48,889962.34
2021-07-17,Cheque,1074171.0,0.0,1964133.34
2021-07-17,Bill,0.0,392826.67,1571306.67
2021-07-17,Commission,94370.03,0.0,1665676.7
2021-07-17,NEFT,0.0,832838.35,832838.35
2021-07-17,Cheque,47.18,0.0,832885.53
2021-07-17,Commission,0.0,83288.55,749596.98
2021-07-17,Reversal,214.92,0.0,749811.9
2021-07-17,Debit Card,0.0,249937.3,499874.6
2021-07-17,Cash,53.08,0.0,499927.68
2021-07-18,Reversal,0.0,249963.84,249963.84
2021-07-18,Debit Card,0.0,31245.48,218718.36
2021-07-18,Purchase,227453.0,0.0,446171.36
2021-07-18,Commission,0.0,446171.36,0.0
2021-07-18,Reversal,41125.19,0.0,41125.19
2021-07-18,Transfer,91.1,0.0,41216.29
2021-07-18,ATM,0.0,8243.26,32973.03
2021-07-18,Tax,0.0,8243.26,24729.77
2021-07-18,Cash,0.0,4121.63,20608.14
2021-07-18,Debit Card,0.0,5152.04,15456.1
2021-07-18,Miscellaneous,597.0,0.0,16053.1
2021-07-18,IMPS,80907.22,0.0,96960.32
2021-07-18,Transfer,0.0,48480.16,48480.16
2021-07-18,Cheque,59.37,0.0,48539.53
2021-07-19,NEFT,3569.0,0.0,52108.53
2021-07-19,Commission,0.1,0.0,52108.63
2021-07-19,Tax,0.0,8684.77,43423.86
2021-07-19,Purchase,0.0,43423.86,0.0
2021-07-19,Cheque,0.8,0.0,0.8
2021-07-19,Cheque,0.31,0.0,1.11
2021-07-19,NEFT,0.0,0.28,0.83
2021-07-19,NEFT,0.0,0.08,0.75
2021-07-19,Commission,0.0,0.25,0.5
2021-07-19,Reversal,0.0,0.06,0.44
2021-07-19,NEFT,1.5,0.0,1.94
2021-07-19,NEFT,0.0,0.32,1.62
2021-07-19,Cheque,338634.0,0.0,338635.62
2021-07-19,Reversal,3737.95,0.0,342373.57
2021-07-19,Miscellaneous,0.0,57062.26,285311.31
2021-07-19,NEFT,22889.0,0.0,308200.31
2021-07-19,IMPS,0.0,44028.62,264171.69
2021-07-19,IMPS,0.0,26417.17,237754.52
2021-07-19,Debit Card,0.0,23775.45,213979.07
2021-07-19,Purchase,0.0,21397.91,192581.16
2021-07-19,Cheque,0.0,19258.12,173323.04
2021-07-19,Bill,28869.7,0.0,202192.74
2021-07-19,Bill,2924.0,0.0,205116.74
2021-07-19,Reversal,4068.0,0.0,209184.74
2021-07-20,Tax,3.0,0.0,209187.74
2021-07-20,Interest,2.06,0.0,209189.8
2021-07-20,Purchase,136.0,0.0,209325.8
2021-07-20,Interest,6.8,0.0,209332.6
2021-07-20,Bill,1033526.0,0.0,1242858.6
2021-07-20,Tax,4677.8,0.0,1247536.4
2021-07-20,Cheque,1.2,0.0,1247537.6
2021-07-20,Debit Card,0.0,138615.29,1108922.31
2021-07-20,Cheque,491.6,0.0,1109413.91
2021-07-20,Cheque,0.0,277353.48,832060.43
2021-07-20,Commission,280466.5,0.0,1112526.93
2021-07-20,Tax,0.0,139065.87,973461.06
2021-07-20,Cash,436.8,0.0,973897.86
2021-07-20,Purchase,601.98,0.0,974499.84
2021-07-20,NEFT,0.0,97449.98,877049.86
2021-07-20,RTGS,1880.6,0.0,878930.46
2021-07-20,Interest,6560.4,0.0,885490.86
2021-07-20,Cash,1806.0,0.0,887296.86
2021-07-20,Bill,0.0,126756.69,760540.17
2021-07-20,Debit Card,0.0,152108.03,608432.14
2021-07-20,Cash,126772.25,0.0,735204.39
2021-07-20,Transfer,0.0,122534.07,612670.32
2021-07-20,Bill,0.0,153167.58,459502.74
2021-07-20,NEFT,0.0,91900.55,367602.19
2021-07-20,IMPS,36249.62,0.0,403851.81
2021-07-20,ATM,3115.22,0.0,406967.03
2021-07-20,Reversal,15224.0,0.0,422191.03
2021-07-20,Purchase,0.0,105547.76,316643.27
2021-07-20,Commission,13747.0,0.0,330390.27
2021-07-20,Transfer,0.0,66078.05,264312.22
2021-07-20,Bill,0.0,264312.22,0.0
2021-07-20,RTGS,3.4,0.0,3.4
2021-07-20,Interest,0.0,3.4,0.0
2021-07-20,Transfer,239718.84,0.0,239718.84
2021-07-20,Interest,0.0,239718.84,0.0
2021-07-20,Debit Card,1130636.0,0.0,1130636.0
2021-07-20,ATM,0.0,226127.2,904508.8
2021-07-20,Commission,0.0,100500.98,804007.82
2021-07-20,Cheque,82397.9,0.0,886405.72
2021-07-20,ATM,0.0,147734.29,738671.43
2021-07-21,Cheque,271.6,0.0,738943.03
2021-07-21,Tax,0.0,92367.88,646575.15
2021-07-21,Tax,33.0,0.0,646608.15
2021-07-21,Interest,425.22,0.0,647033.37
2021-07-21,NEFT,3796.5,0.0,650829.87
2021-07-21,Transfer,3.0,0.0,650832.87
2021-07-21,Miscellaneous,0.0,92976.12,557856.75
2021-07-21,Tax,0.0,55785.68,502071.08
2021-07-21,Bill,0.0,125517.77,376553.31
2021-07-21,RTGS,0.0,125517.77,251035.54
2021-07-21,Cash,0.0,50207.11,200828.43
2021-07-21,NEFT,0.0,200828.43,0.0
2021-07-21,Miscellaneous,1716346.0,0.0,1716346.0
2021-07-21,NEFT,0.0,286057.67,1430288.33
2021-07-21,Bill,3520.3,0.0,1433808.63
2021-07-21,Purchase,146.59,0.0,1433955.22
2021-07-21,Miscellaneous,0.0,286791.04,1147164.18
2021-07-21,Interest,0.0,127462.69,1019701.49
2021-07-21,Tax,0.0,254925.37,764776.12
2021-07-22,Reversal,0.0,191194.03,573582.09
2021-07-22,RTGS,0.0,63731.34,509850.75
2021-07-22,Bill,0.0,101970.15,407880.6
2021-07-22,Bill,1718065.5,0.0,2125946.1
2021-07-22,Bill,0.0,708648.7,1417297.4
2021-07-22,Cheque,9943.0,0.0,1427240.4
2021-07-22,Cheque,439.65,0.0,1427680.05
2021-07-22,Commission,0.0,178460.01,1249220.04
2021-07-22,Debit Card,0.0,624610.02,624610.02
2021-07-22,Cash,0.0,69401.11,555208.91
2021-07-22,Cash,13.0,0.0,555221.91
2021-07-22,Tax,0.0,69402.74,485819.17
2021-07-22,Reversal,25497.1,0.0,511316.27
2021-07-22,Transfer,21.0,0.0,511337.27
2021-07-22,Cash,1669269.0,0.0,2180606.27
2021-07-22,Debit Card,14289.0,0.0,2194895.27
2021-07-22,Bill,20737.0,0.0,2215632.27
2021-07-22,Cash,38.9,0.0,2215671.17
2021-07-22,Cheque,20.3,0.0,2215691.47
2021-07-22,Miscellaneous,0.0,738563.82,1477127.65
2021-07-22,Commission,0.0,492375.88,984751.77
2021-07-22,Cheque,0.0,246187.94,738563.83
2021-07-22,Reversal,0.0,738563.83,0.0
2021-07-22,IMPS,38.5,0.0,38.5
2021-07-22,NEFT,3975.7,0.0,4014.2
2021-07-22,RTGS,58.6,0.0,4072.8
2021-07-22,IMPS,0.0,814.56,3258.24
2021-07-22,Bill,31559.8,0.0,34818.04
2021-07-22,Reversal,0.0,34818.04,0.0
2021-07-22,Miscellaneous,3.0,0.0,3.0
2021-07-22,Commission,44.0,0.0,47.0
2021-07-22,Cash,4.6,0.0,51.6
2021-07-22,Cash,4064.7,0.0,4116.3
2021-07-22,Reversal,0.0,4116.3,0.0
2021-07-22,IMPS,2475.35,0.0,2475.35
2021-07-22,NEFT,6.94,0.0,2482.29
2021-07-22,Reversal,508.1,0.0,2990.39
2021-07-22,Cash,1747891.0,0.0,1750881.39
2021-07-22,Reversal,153708.8,0.0,1904590.19
2021-07-22,Cash,0.0,190459.02,1714131.17
2021-07-22,Cash,271.86,0.0,1714403.03
2021-07-22,Transfer,11799.0,0.0,1726202.03
2021-07-22,ATM,0.0,172620.2,1553581.83
2021-07-22,Interest,857.0,0.0,1554438.83
2021-07-22,Transfer,1358.9,0.0,1555797.73
2021-07-22,Tax,30253.0,0.0,1586050.73
2021-07-22,Miscellaneous,0.0,396512.68,1189538.05
2021-07-22,Commission,1320602.5,0.0,2510140.55
2021-07-22,Miscellaneous,0.0,836713.52,1673427.03
2021-07-22,Tax,1642.81,0.0,1675069.84
2021-07-22,Purchase,1840447.75,0.0,3515517.59
2021-07-22,Transfer,1919.6,0.0,3517437.19
2021-07-22,RTGS,0.0,351743.72,3165693.47
2021-07-22,Miscellaneous,4.0,0.0,3165697.47
2021-07-22,ATM,0.0,633139.49,2532557.98
2021-07-22,NEFT,21917.76,0.0,2554475.74
2021-07-22,Transfer,0.0,255447.57,2299028.17
2021-07-22,Commission,34.0,0.0,2299062.17
2021-07-22,Cheque,668.14,0.0,2299730.31
2021-07-22,Cash,0.0,574932.58,1724797.73
2021-07-22,Miscellaneous,4.65,0.0,1724802.38
2021-07-22,Transfer,0.0,215600.3,1509202.08
2021-07-22,Transfer,0.0,754601.04,754601.04
2021-07-22,Interest,923334.5,0.0,1677935.54
2021-07-22,Commission,226877.78,0.0,1904813.32
2021-07-22,Tax,1868.06,0.0,1906681.38
2021-07-22,Reversal,0.0,238335.17,1668346.21
2021-07-22,RTGS,467.37,0.0,1668813.58
2021-07-22,Debit Card,1879505.25,0.0,3548318.83
2021-07-22,Purchase,3.3,0.0,3548322.13
2021-07-22,Transfer,51.97,0.0,3548374.1
2021-07-22,IMPS,4.4,0.0,3548378.5
2021-07-22,Interest,1388.16,0.0,3549766.66
2021-07-22,Tax,388.0,0.0,3550154.66
2021-07-22,Cheque,0.0,443769.33,3106385.33
2021-07-22,Transfer,2.0,0.0,3106387.33
2021-07-22,NEFT,7.0,0.0,3106394.33
2021-07-22,Commission,0.0,443770.62,2662623.71
2021-07-22,Cheque,1.0,0.0,2662624.71
2021-07-22,Purchase,223262.0,0.0,2885886.71
2021-07-22,Bill,7.0,0.0,2885893.71
2021-07-22,Tax,0.0,480982.29,2404911.42
2021-07-22,NEFT,0.0,300613.93,2104297.49
2021-07-23,Transfer,22.41,0.0,2104319.9
2021-07-23,Purchase,0.0,210431.99,1893887.91
2021-07-23,Transfer,1.6,0.0,1893889.51
2021-07-23,IMPS,60817.0,0.0,1954706.51
2021-07-23,Miscellaneous,0.0,390941.3,1563765.21
2021-07-23,ATM,202900.03,0.0,1766665.24
2021-07-23,Bill,0.0,441666.31,1324998.93
2021-07-23,ATM,0.0,331249.73,993749.2
2021-07-23,Commission,435.0,0.0,994184.2
2021-07-23,Purchase,0.0,198836.84,795347.36
2021-07-23,Reversal,598.0,0.0,795945.36
2021-07-24,ATM,211418.09,0.0,1007363.45
2021-07-24,RTGS,0.0,125920.43,881443.02
2021-07-24,Commission,48.6,0.0,881491.62
2021-07-24,Bill,0.0,97943.51,783548.11
2021-07-24,Reversal,0.0,130591.35,652956.76
2021-07-24,Miscellaneous,361.0,0.0,653317.76
2021-07-24,Debit Card,592745.2,0.0,1246062.96
2021-07-24,ATM,6.0,0.0,1246068.96
2021-07-24,IMPS,0.0,249213.79,996855.17
2021-07-24,IMPS,58271.0,0.0,1055126.17
2021-07-24,Miscellaneous,11627.7,0.0,1066753.87
2021-07-24,NEFT,3249.7,0.0,1070003.57
2021-07-24,Bill,261.9,0.0,1070265.47
2021-07-24,Debit Card,1766479.5,0.0,2836744.97
2021-07-24,Cash,0.0,709186.24,2127558.73
2021-07-24,Debit Card,0.0,303936.96,1823621.77
2021-07-24,Purchase,432.7,0.0,1824054.47
2021-07-24,Transfer,54.5,0.0,1824108.97
2021-07-24,ATM,13.0,0.0,1824121.97
2021-07-24,NEFT,30.0,0.0,1824151.97
2021-07-24,Reversal,22989.75,0.0,1847141.72
2021-07-24,Purchase,0.0,230892.72,1616249.0
2021-07-24,Tax,0.0,161624.9,1454624.1
2021-07-24,Miscellaneous,0.0,290924.82,1163699.28
2021-07-24,Transfer,106.0,0.0,1163805.28
2021-07-24,Transfer,23008.51,0.0,1186813.79
2021-07-24,Purchase,0.0,593406.9,593406.9
2021-07-24,Bill,0.0,197802.3,395604.6
2021-07-24,Cash,0.0,43956.07,351648.53
2021-07-24,Cash,67.37,0.0,351715.9
2021-07-24,RTGS,4.7,0.0,351720.6
2021-07-24,IMPS,0.0,70344.12,281376.48
2021-07-24,Debit Card,0.0,31264.05,250112.43
2021-07-24,IMPS,0.0,125056.22,125056.22
2021-07-24,NEFT,216.69,0.0,125272.91
2021-07-24,Purchase,0.0,13919.21,111353.7
2021-07-24,NEFT,3314.0,0.0,114667.7
2021-07-24,IMPS,0.0,11466.77,103200.93
2021-07-24,Bill,0.3,0.0,103201.23
2021-07-24,Debit Card,2815.0,0.0,106016.23
2021-07-24,Purchase,0.0,35338.74,70677.49
2021-07-25,ATM,0.0,8834.69,61842.8
2021-07-25,Tax,168.0,0.0,62010.8
2021-07-25,RTGS,0.0,20670.27,41340.53
2021-07-25,Tax,28672.0,0.0,70012.53
2021-07-26,Transfer,0.0,11668.76,58343.78
2021-07-26,NEFT,19.41,0.0,58363.19
2021-07-26,Cash,0.0,6484.8,51878.39
2021-07-26,Cheque,0.0,12969.6,38908.79
2021-07-26,Miscellaneous,0.0,9727.2,29181.59
2021-07-26,Purchase,0.0,4863.6,24317.99
2021-07-26,ATM,3.39,0.0,24321.38
2021-07-26,Debit Card,0.0,4864.28,19457.1
2021-07-26,RTGS,0.0,4864.28,14592.82
2021-07-26,Tax,0.0,2084.69,12508.13
2021-07-26,Bill,361.7,0.0,12869.83
2021-07-26,Miscellaneous,0.0,12869.83,0.0
2021-07-26,NEFT,686.0,0.0,686.0
2021-07-26,Reversal,0.0,68.6,617.4
2021-07-26,Tax,7.5,0.0,624.9
2021-07-26,RTGS,0.0,208.3,416.6
2021-07-26,Debit Card,62.0,0.0,478.6
2021-07-26,Cash,19630.0,0.0,20108.6
2021-07-26,ATM,0.0,6702.87,13405.73
2021-07-26,RTGS,30188.0,0.0,43593.73
2021-07-26,Debit Card,118586.0,0.0,162179.73
2021-07-26,Commission,0.0,23168.53,139011.2
2021-07-26,Debit Card,211.0,0.0,139222.2
2021-07-26,Tax,134.2,0.0,139356.4
2021-07-26,RTGS,0.0,23226.07,116130.33
2021-07-26,IMPS,0.0,12903.37,103226.96
2021-07-26,Debit Card,0.0,11469.66,91757.3
2021-07-26,IMPS,0.0,22939.33,68817.98
2021-07-26,Bill,54.0,0.0,68871.98
2021-07-26,Interest,0.0,68871.98,0.0
2021-07-26,Transfer,6.0,0.0,6.0
2021-07-27,Miscellaneous,2533.0,0.0,2539.0
2021-07-27,ATM,0.0,846.33,1692.67
2021-07-27,RTGS,288.8,0.0,1981.47
2021-07-27,RTGS,0.0,1981.47,0.0
2021-07-27,RTGS,64481.59,0.0,64481.59
2021-07-27,ATM,12.0,0.0,64493.59
2021-07-27,RTGS,386.4,0.0,64879.99
2021-07-27,Debit Card,101.88,0.0,64981.87
2021-07-27,Reversal,0.0,8122.73,56859.14
2021-07-27,Purchase,0.0,9476.52,47382.62
2021-07-28,NEFT,3514.2,0.0,50896.82
2021-07-28,Bill,302.3,0.0,51199.12
2021-07-28,Reversal,0.0,7314.16,43884.96
2021-07-28,Purchase,0.0,7314.16,36570.8
2021-07-28,Reversal,0.0,4571.35,31999.45
2021-07-28,RTGS,0.0,31999.45,0.0
2021-07-28,ATM,3.9,0.0,3.9
2021-07-28,Bill,4098.7,0.0,4102.6
2021-07-28,Debit Card,2.0,0.0,4104.6
2021-07-28,Cheque,266.0,0.0,4370.6
2021-07-28,Cheque,0.0,485.62,3884.98
2021-07-28,Purchase,0.0,777.0,3107.98
2021-07-28,ATM,16522.0,0.0,19629.98
2021-07-28,Debit Card,533.75,0.0,20163.73
2021-07-28,Reversal,2693.0,0.0,22856.73
2021-07-28,Cheque,4.15,0.0,22860.88
2021-07-28,Transfer,0.0,3265.84,19595.04
2021-07-28,Reversal,299243.0,0.0,318838.04
2021-07-28,Bill,0.0,53139.67,265698.37
2021-07-28,IMPS,146.4,0.0,265844.77
2021-07-28,Reversal,316084.0,0.0,581928.77
2021-07-28,Interest,0.0,193976.26,387952.51
2021-07-28,ATM,0.0,77590.5,310362.01
2021-07-28,Bill,0.0,51727.0,258635.01
2021-07-28,Reversal,1838039.2,0.0,2096674.21
2021-07-28,Miscellaneous,0.0,0.0,2096674.21
2021-07-29,Cash,13332.57,0.0,2110006.78
2021-07-29,RTGS,0.0,2110006.78,0.0
2021-07-29,Bill,40.1,0.0,40.1
2021-07-29,Miscellaneous,143966.0,0.0,144006.1
2021-07-29,Interest,0.0,28801.22,115204.88
2021-07-29,Cash,0.0,115204.88,0.0
2021-07-29,ATM,1230.99,0.0,1230.99
2021-07-29,Interest,0.0,136.78,1094.21
2021-07-29,Bill,0.0,156.32,937.89
2021-07-29,RTGS,48.0,0.0,985.89
2021-07-29,IMPS,790272.25,0.0,791258.14
2021-07-29,Interest,0.0,131876.36,659381.78
2021-07-29,ATM,55352.0,0.0,714733.78
2021-07-29,Tax,1377.01,0.0,716110.79
2021-07-29,Cash,0.0,143222.16,572888.63
2021-07-29,Reversal,1797005.0,0.0,2369893.63
2021-07-29,Bill,3.44,0.0,2369897.07
2021-07-29,IMPS,3319.0,0.0,2373216.07
2021-07-29,ATM,17652.0,0.0,2390868.07
2021-07-30,IMPS,0.0,298858.51,2092009.56
2021-07-30,Tax,0.0,261501.2,1830508.36
2021-07-30,Reversal,11322.0,0.0,1841830.36
2021-07-30,Cash,62.14,0.0,1841892.5
2021-07-30,Debit Card,95.42,0.0,1841987.92
2021-07-30,Transfer,0.0,368397.58,1473590.34
2021-07-30,ATM,0.0,163732.26,1309858.08
2021-07-30,Commission,0.0,261971.62,1047886.46
2021-07-30,NEFT,1279.0,0.0,1049165.46
2021-07-31,NEFT,0.0,349721.82,699443.64
2021-07-31,Miscellaneous,0.0,174860.91,524582.73
2021-07-31,ATM,7.9,0.0,524590.63
2021-07-31,Tax,217.53,0.0,524808.16
2021-07-31,Tax,0.0,87468.03,437340.13
2021-07-31,RTGS,166805.31,0.0,604145.44
2021-07-31,Interest,0.0,67127.27,537018.17
2021-07-31,NEFT,0.0,179006.06,358012.11
2021-07-31,Bill,331728.0,0.0,689740.11
2021-07-31,Reversal,48.0,0.0,689788.11
2021-07-31,ATM,0.0,86223.51,603564.6
2021-07-31,Commission,0.0,150891.15,452673.45
2021-07-31,Reversal,0.0,56584.18,396089.27
2021-08-01,Reversal,0.0,99022.32,297066.95
2021-08-01,Miscellaneous,4.9,0.0,297071.85
2021-08-01,NEFT,61.1,0.0,297132.95
2021-08-01,Cash,94.93,0.0,297227.88
2021-08-01,Miscellaneous,22.8,0.0,297250.68
2021-08-01,Miscellaneous,0.0,37156.34,260094.34
2021-08-01,ATM,0.0,260094.34,0.0
2021-08-01,Commission,87337.1,0.0,87337.1
2021-08-01,NEFT,90266.81,0.0,177603.91
2021-08-01,Tax,50.2,0.0,177654.11
2021-08-01,RTGS,5524.8,0.0,183178.91
2021-08-01,Interest,0.0,61059.64,122119.27
2021-08-01,Interest,4039.77,0.0,126159.04
2021-08-01,NEFT,22237.5,0.0,148396.54
2021-08-01,Tax,49.5,0.0,148446.04
2021-08-01,NEFT,0.0,14844.6,133601.44
2021-08-01,Commission,13.0,0.0,133614.44
2021-08-01,IMPS,0.0,14846.05,118768.39
2021-08-01,RTGS,6.3,0.0,118774.69
2021-08-01,Interest,164492.22,0.0,283266.91
2021-08-01,Miscellaneous,587527.5,0.0,870794.41
2021-08-01,ATM,336.2,0.0,871130.61
2021-08-01,IMPS,2561.0,0.0,873691.61
2021-08-01,Cheque,0.0,218422.9,655268.71
2021-08-01,Transfer,0.0,81908.59,573360.12
2021-08-01,Bill,0.0,143340.03,430020.09
2021-08-01,Reversal,0.0,43002.01,387018.08
2021-08-01,Cheque,1448679.8,0.0,1835697.88
2021-08-01,Interest,0.0,458924.47,1376773.41
2021-08-01,Cheque,462.6,0.0,1377236.01
2021-08-01,Purchase,387.16,0.0,1377623.17
2021-08-01,IMPS,24660.42,0.0,1402283.59
2021-08-01,RTGS,0.0,701141.8,701141.8
2021-08-01,Purchase,46214.03,0.0,747355.83
2021-08-01,Commission,10.0,0.0,747365.83
2021-08-01,Cash,0.0,373682.92,373682.92
2021-08-01,IMPS,1965235.5,0.0,2338918.42
2021-08-01,Purchase,476.6,0.0,2339395.02
2021-08-01,Reversal,6.81,0.0,2339401.83
2021-08-01,Purchase,3.0,0.0,2339404.83
2021-08-01,Cheque,0.0,292425.6,2046979.23
2021-08-01,ATM,0.0,341163.21,1705816.02
2021-08-01,IMPS,7.9,0.0,1705823.92
2021-08-01,Commission,261614.5,0.0,1967438.42
2021-08-01,NEFT,0.0,983719.21,983719.21
2021-08-01,IMPS,0.0,163953.2,819766.01
2021-08-01,NEFT,336.0,0.0,820102.01
2021-08-01,ATM,46.0,0.0,820148.01
2021-08-01,Cheque,683.51,0.0,820831.52
2021-08-01,Debit Card,0.0,91203.5,729628.02
2021-08-01,Transfer,0.0,182407.01,547221.02
2021-08-01,Purchase,199.84,0.0,547420.86
2021-08-01,Cash,0.0,273710.43,273710.43
2021-08-01,Bill,0.0,39101.49,234608.94
2021-08-01,Interest,0.0,29326.12,205282.82
2021-08-01,NEFT,0.0,25660.35,179622.47
2021-08-01,Commission,0.0,89811.24,89811.24
2021-08-01,Transfer,4.92,0.0,89816.16
2021-08-01,Bill,2256.7,0.0,92072.86
2021-08-01,Transfer,0.0,11509.11,80563.75
2021-08-01,Tax,0.0,16112.75,64451.0
2021-08-01,Bill,18475.08,0.0,82926.08
2021-08-01,Tax,0.0,9214.01,73712.07
2021-08-01,Reversal,0.0,14742.41,58969.66
2021-08-01,Transfer,0.0,5896.97,53072.69
2021-08-01,Commission,216409.0,0.0,269481.69
2021-08-01,Cheque,1813738.0,0.0,2083219.69
2021-08-01,Cheque,460.0,0.0,2083679.69
2021-08-01,RTGS,7.0,0.0,2083686.69
2021-08-01,Miscellaneous,0.0,231520.74,1852165.95
2021-08-01,Tax,16149.0,0.0,1868314.95
2021-08-01,Cash,0.0,934157.48,934157.48
2021-08-01,Purchase,446.6,0.0,934604.08
2021-08-01,Bill,19290.7,0.0,953894.78
2021-08-01,Bill,2012.0,0.0,955906.78
2021-08-01,Interest,1390219.8,0.0,2346126.58
2021-08-01,IMPS,1.4,0.0,2346127.98
2021-08-01,Cash,12.0,0.0,2346139.98
2021-08-01,Bill,2380.0,0.0,2348519.98
2021-08-01,Purchase,0.0,391420.0,1957099.98
2021-08-01,Bill,0.0,391420.0,1565679.98
2021-08-01,Transfer,18.6,0.0,1565698.58
2021-08-01,Tax,7.2,0.0,1565705.78
2021-08-01,NEFT,18.1,0.0,1565723.88
2021-08-01,Transfer,0.0,195715.49,1370008.4
2021-08-02,Debit Card,41.2,0.0,1370049.6
2021-08-02,Bill,0.6,0.0,1370050.2
2021-08-02,Cheque,18.4,0.0,1370068.6
2021-08-02,Bill,0.0,195724.09,1174344.51
2021-08-02,Tax,0.0,195724.09,978620.42
2021-08-02,Debit Card,1472076.0,0.0,2450696.42
2021-08-02,Debit Card,1.67,0.0,2450698.09
2021-08-02,RTGS,82253.5,0.0,2532951.59
2021-08-02,Cash,0.0,506590.32,2026361.27
2021-08-02,Miscellaneous,2.4,0.0,2026363.67
2021-08-02,ATM,143785.0,0.0,2170148.67
2021-08-02,ATM,128977.06,0.0,2299125.73
2021-08-02,RTGS,0.0,574781.43,1724344.3
2021-08-02,Commission,0.0,191593.81,1532750.49
2021-08-02,Cheque,0.0,766375.25,766375.24
2021-08-02,ATM,25437.6,0.0,791812.84
2021-08-02,Commission,329987.25,0.0,1121800.09
2021-08-02,NEFT,17.34,0.0,1121817.43
2021-08-02,NEFT,20734.26,0.0,1142551.69
2021-08-02,IMPS,2.9,0.0,1142554.59
2021-08-02,Tax,1355590.25,0.0,2498144.84
2021-08-02,Cheque,4003.9,0.0,2502148.74
2021-08-03,ATM,0.0,2502148.74,0.0
2021-08-03,Bill,8.0,0.0,8.0
2021-08-03,ATM,0.0,1.6,6.4
2021-08-03,RTGS,153.9,0.0,160.3
2021-08-03,Transfer,0.0,80.15,80.15
2021-08-03,ATM,3583.85,0.0,3664.0
2021-08-03,Interest,254454.0,0.0,258118.0
2021-08-03,NEFT,0.0,258118.0,0.0
2021-08-04,Interest,0.0,0.0,0.0
2021-08-05,RTGS,6.1,0.0,6.1
2021-08-05,Bill,0.0,1.22,4.88
2021-08-05,Tax,30367.0,0.0,30371.88
2021-08-05,ATM,0.0,3374.65,26997.23
2021-08-05,Debit Card,229057.0,0.0,256054.23
2021-08-06,IMPS,30058.29,0.0,286112.52
2021-08-06,ATM,0.0,143056.26,143056.26
2021-08-06,Debit Card,181637.97,0.0,324694.23
2021-08-06,Miscellaneous,0.0,40586.78,284107.45
2021-08-06,IMPS,92351.0,0.0,376458.45
2021-08-06,Debit Card,3860.03,0.0,380318.48
2021-08-06,Transfer,0.0,42257.61,338060.87
2021-08-06,Reversal,0.0,67612.17,270448.7
2021-08-06,Cash,97791.03,0.0,368239.73
2021-08-06,Commission,0.0,40915.53,327324.2
2021-08-06,ATM,1323829.75,0.0,1651153.95
2021-08-06,ATM,34.3,0.0,1651188.25
2021-08-06,Transfer,21650.43,0.0,1672838.68
2021-08-06,RTGS,0.0,418209.67,1254629.01
2021-08-06,Reversal,0.0,250925.8,1003703.21
2021-08-06,IMPS,0.1,0.0,1003703.31
2021-08-06,Debit Card,995294.0,0.0,1998997.31
2021-08-06,Cash,1357968.0,0.0,3356965.31
2021-08-06,Transfer,420.0,0.0,3357385.31
2021-08-06,Reversal,6717.0,0.0,3364102.31
2021-08-06,RTGS,4983.0,0.0,3369085.31
2021-08-06,Tax,18479.92,0.0,3387565.23
2021-08-07,IMPS,984.0,0.0,3388549.23
2021-08-07,Tax,0.0,1694274.62,1694274.62
2021-08-07,Transfer,0.0,242039.23,1452235.39
2021-08-07,Cash,0.0,242039.23,1210196.16
2021-08-07,Tax,15011.03,0.0,1225207.19
2021-08-07,Tax,0.0,122520.72,1102686.47
2021-08-07,Interest,219692.9,0.0,1322379.37
2021-08-07,Tax,0.05,0.0,1322379.42
2021-08-07,Cash,0.0,1322379.42,0.0
2021-08-07,NEFT,2576.0,0.0,2576.0
2021-08-07,Interest,0.0,515.2,2060.8
2021-08-07,Bill,373.0,0.0,2433.8
2021-08-07,Reversal,0.0,243.38,2190.42
2021-08-07,Tax,132.0,0.0,2322.42
2021-08-07,Debit Card,63.0,0.0,2385.42
2021-08-07,Miscellaneous,0.0,397.57,1987.85
2021-08-07,Cheque,259247.0,0.0,261234.85
2021-08-07,Commission,0.0,37319.26,223915.59
2021-08-07,ATM,49.4,0.0,223964.99
2021-08-07,Reversal,0.0,37327.5,186637.49
2021-08-07,ATM,0.0,93318.75,93318.74
2021-08-07,ATM,3497.04,0.0,96815.78
2021-08-07,NEFT,372.0,0.0,97187.78
2021-08-07,Cheque,0.0,48593.89,48593.89
2021-08-07,Reversal,0.0,12148.47,36445.42
2021-08-07,ATM,4.5,0.0,36449.92
2021-08-07,Interest,3372.23,0.0,39822.15
2021-08-07,RTGS,0.0,4977.77,34844.38
2021-08-07,Commission,0.0,3871.6,30972.78
2021-08-07,Commission,0.0,3871.6,27101.18
2021-08-07,Miscellaneous,0.0,2710.12,24391.06
2021-08-07,Reversal,0.0,12195.53,12195.53
2021-08-07,IMPS,0.0,1742.22,10453.31
2021-08-07,Tax,0.0,1045.33,9407.98
2021-08-07,Bill,31283.0,0.0,40690.98
2021-08-07,Miscellaneous,0.0,13563.66,27127.32
2021-08-07,Reversal,0.0,9042.44,18084.88
2021-08-07,NEFT,0.0,18084.88,0.0
2021-08-07,NEFT,1075455.2,0.0,1075455.2
2021-08-07,Cash,0.0,1075455.2,0.0
2021-08-07,Cash,50.87,0.0,50.87
2021-08-07,Bill,0.0,7.27,43.6
2021-08-07,Tax,26287.04,0.0,26330.64
2021-08-07,Transfer,27802.5,0.0,54133.14
2021-08-07,Transfer,0.0,6014.79,48118.35
2021-08-07,Bill,0.0,9623.67,38494.68
2021-08-07,RTGS,50.0,0.0,38544.68
2021-08-07,ATM,6.0,0.0,38550.68
2021-08-07,ATM,0.0,4283.41,34267.27
2021-08-07,Bill,0.0,3807.47,30459.8
2021-08-07,Commission,0.0,10153.27,20306.53
2021-08-07,Bill,6.71,0.0,20313.24
2021-08-07,Commission,0.0,5078.31,15234.93
2021-08-07,Cheque,1973.7,0.0,17208.63
2021-08-07,NEFT,1.58,0.0,17210.21
2021-08-07,Tax,12.74,0.0,17222.95
2021-08-07,Debit Card,0.0,17222.95,0.0
2021-08-07,Interest,201308.8,0.0,201308.8
2021-08-07,Debit Card,226.6,0.0,201535.4
2021-08-07,Transfer,0.0,201535.4,0.0
2021-08-07,Cash,6.0,0.0,6.0
2021-08-07,NEFT,0.0,2.0,4.0
2021-08-07,Cash,0.0,0.67,3.33
2021-08-07,Commission,189429.4,0.0,189432.73
2021-08-07,Interest,0.81,0.0,189433.54
2021-08-07,Transfer,0.0,94716.77,94716.77
2021-08-07,NEFT,0.0,11839.6,82877.17
2021-08-07,Bill,0.0,10359.65,72517.52
2021-08-07,Cheque,9.77,0.0,72527.29
2021-08-07,Transfer,234979.0,0.0,307506.29
2021-08-07,Miscellaneous,0.0,102502.1,205004.19
2021-08-07,Tax,225004.1,0.0,430008.29
2021-08-07,Transfer,1562084.75,0.0,1992093.04
2021-08-07,Miscellaneous,0.0,249011.63,1743081.41
2021-08-07,Commission,3432.0,0.0,1746513.41
2021-08-07,NEFT,30.0,0.0,1746543.41
2021-08-07,NEFT,3.0,0.0,1746546.41
2021-08-07,IMPS,61.86,0.0,1746608.27
2021-08-07,ATM,3.6,0.0,1746611.87
2021-08-07,Bill,104626.88,0.0,1851238.75
2021-08-07,Cheque,303.0,0.0,1851541.75
2021-08-07,Debit Card,0.0,264505.96,1587035.79
2021-08-07,Interest,148600.0,0.0,1735635.79
2021-08-07,Reversal,23.0,0.0,1735658.79
2021-08-07,Commission,72.7,0.0,1735731.49
2021-08-07,RTGS,44440.44,0.0,1780171.93
2021-08-07,Commission,47.0,0.0,1780218.93
2021-08-08,Debit Card,25.0,0.0,1780243.93
2021-08-08,NEFT,211.5,0.0,1780455.43
2021-08-08,Bill,0.0,445113.86,1335341.57
2021-08-08,NEFT,0.0,1335341.57,0.0
2021-08-08,Tax,1469.55,0.0,1469.55
2021-08-08,Bill,23.89,0.0,1493.44
2021-08-08,Transfer,1988.67,0.0,3482.11
2021-08-08,Bill,1744521.25,0.0,1748003.36
2021-08-08,IMPS,0.0,874001.68,874001.68
2021-08-08,NEFT,2.69,0.0,874004.37
2021-08-08,Cash,0.0,218501.09,655503.28
2021-08-09,Interest,0.0,81937.91,573565.37
2021-08-09,Debit Card,0.0,57356.54,516208.83
2021-08-09,Transfer,247681.2,0.0,763890.03
2021-08-09,Interest,0.0,381945.02,381945.02
2021-08-09,Purchase,0.0,47743.13,334201.89
2021-08-09,Cheque,0.0,167100.95,167100.94
2021-08-09,Transfer,175231.59,0.0,342332.53
2021-08-09,Cheque,0.0,57055.42,285277.11
2021-08-09,Transfer,0.0,95092.37,190184.74
2021-08-09,Cheque,702084.0,0.0,892268.74
2021-08-09,Purchase,0.0,223067.19,669201.55
2021-08-09,Tax,164801.0,0.0,834002.55
2021-08-09,Cheque,0.0,92666.95,741335.6
2021-08-09,Reversal,0.0,247111.87,494223.73
2021-08-09,RTGS,1013186.8,0.0,1507410.53
2021-08-09,Debit Card,8072.06,0.0,1515482.59
2021-08-09,Miscellaneous,0.0,303096.52,1212386.07
2021-08-09,Cash,0.0,121238.61,1091147.46
2021-08-09,Reversal,0.0,545573.73,545573.73
2021-08-09,Debit Card,5.0,0.0,545578.73
2021-08-09,Tax,14475.93,0.0,560054.66
2021-08-09,NEFT,0.0,112010.93,448043.73
2021-08-09,ATM,0.0,224021.87,224021.86
2021-08-09,Bill,35571.0,0.0,259592.86
2021-08-09,Interest,0.0,51918.57,207674.29
2021-08-09,NEFT,0.0,51918.57,155755.72
2021-08-09,Cheque,0.0,31151.14,124604.58
2021-08-09,Tax,0.0,41534.86,83069.72
2021-08-09,NEFT,0.0,16613.94,66455.78
2021-08-09,Cheque,119643.0,0.0,186098.78
2021-08-09,Interest,28185.8,0.0,214284.58
2021-08-09,Tax,0.0,42856.92,171427.66
2021-08-09,Commission,0.0,21428.46,149999.2
2021-08-09,IMPS,0.0,24999.87,124999.33
2021-08-09,RTGS,2.9,0.0,125002.23
2021-08-09,Cheque,151608.9,0.0,276611.13
2021-08-09,Commission,0.0,30734.57,245876.56
2021-08-09,RTGS,0.0,35125.22,210751.34
2021-08-09,Transfer,0.0,52687.84,158063.5
2021-08-09,Tax,60.0,0.0,158123.5
2021-08-09,Miscellaneous,3465.0,0.0,161588.5
2021-08-09,ATM,0.0,23084.07,138504.43
2021-08-09,Cash,24.15,0.0,138528.58
2021-08-09,IMPS,5333.0,0.0,143861.58
2021-08-09,Interest,453.37,0.0,144314.95
2021-08-09,Commission,252969.0,0.0,397283.95
2021-08-09,Debit Card,6.4,0.0,397290.35
2021-08-09,IMPS,300.0,0.0,397590.35
2021-08-10,Cheque,22756.0,0.0,420346.35
2021-08-10,Reversal,0.0,140115.45,280230.9
2021-08-10,Commission,0.0,140115.45,140115.45
2021-08-10,Reversal,46.3,0.0,140161.75
2021-08-10,Purchase,0.0,140161.75,0.0
2021-08-10,Tax,178685.0,0.0,178685.0
2021-08-10,Purchase,0.0,19853.89,158831.11
2021-08-10,Purchase,0.0,19853.89,138977.22
2021-08-10,NEFT,0.0,27795.44,111181.78
2021-08-10,Bill,48.04,0.0,111229.82
2021-08-10,Bill,0.0,13903.73,97326.09
2021-08-10,Cheque,0.0,32442.03,64884.06
2021-08-10,Debit Card,0.0,32442.03,32442.03
2021-08-10,Reversal,608563.0,0.0,641005.03
2021-08-10,Reversal,10.5,0.0,641015.53
2021-08-10,RTGS,46904.56,0.0,687920.09
2021-08-10,ATM,1715.6,0.0,689635.69
2021-08-10,Reversal,65127.75,0.0,754763.44
2021-08-10,Cheque,353849.8,0.0,1108613.24
2021-08-10,Commission,0.0,110861.32,997751.92
2021-08-10,RTGS,0.0,332583.97,665167.95
2021-08-10,Bill,4027.6,0.0,669195.55
2021-08-10,Reversal,0.0,133839.11,535356.44
2021-08-10,Bill,0.0,89226.07,446130.37
2021-08-10,Cash,0.0,111532.59,334597.78
2021-08-10,Cash,0.0,37177.53,297420.25
2021-08-10,Interest,0.0,297420.25,0.0
2021-08-10,Debit Card,10450.84,0.0,10450.84
2021-08-10,Transfer,0.0,2090.17,8360.67
2021-08-10,Debit Card,1541.56,0.0,9902.23
2021-08-10,Reversal,25719.79,0.0,35622.02
2021-08-10,RTGS,55.0,0.0,35677.02
2021-08-10,Reversal,0.0,35677.02,0.0
2021-08-11,Debit Card,526.66,0.0,526.66
2021-08-11,Cash,0.0,52.67,473.99
2021-08-11,IMPS,0.0,473.99,0.0
2021-08-11,ATM,25.1,0.0,25.1
2021-08-11,Debit Card,0.0,25.1,0.0
2021-08-11,Debit Card,34.2,0.0,34.2
2021-08-11,Debit Card,0.0,17.1,17.1
2021-08-11,Commission,0.0,2.44,14.66
2021-08-11,IMPS,0.0,3.67,11.0
2021-08-11,Miscellaneous,0.0,1.1,9.9
2021-08-11,Miscellaneous,0.0,3.3,6.6
2021-08-11,Transfer,6.32,0.0,12.92
2021-08-11,RTGS,1189643.0,0.0,1189655.92
2021-08-12,IMPS,0.0,396551.97,793103.95
2021-08-12,Bill,1.71,0.0,793105.66
2021-08-12,Bill,2272.9,0.0,795378.56
2021-08-12,Purchase,0.0,88375.4,707003.16
2021-08-12,Interest,0.0,353501.58,353501.58
2021-08-12,Commission,0.0,35350.16,318151.42
2021-08-12,IMPS,1390327.25,0.0,1708478.67
2021-08-12,ATM,174.42,0.0,1708653.09
2021-08-12,IMPS,1637956.8,0.0,3346609.89
2021-08-12,RTGS,1043.22,0.0,3347653.11
2021-08-13,Cheque,914106.2,0.0,4261759.31
2021-08-13,IMPS,4.9,0.0,4261764.21
2021-08-13,NEFT,0.0,426176.42,3835587.79
2021-08-13,Commission,0.0,426176.42,3409411.37
2021-08-13,Bill,0.0,1136470.46,2272940.91
2021-08-13,Tax,0.0,757646.97,1515293.94
2021-08-13,IMPS,0.0,757646.97,757646.97
2021-08-13,IMPS,176.1,0.0,757823.07
2021-08-13,Cheque,0.0,378911.54,378911.54
2021-08-13,Reversal,0.0,378911.54,0.0
2021-08-13,IMPS,1.8,0.0,1.8
2021-08-13,Cash,0.0,0.3,1.5
2021-08-13,Cash,280003.2,0.0,280004.7
2021-08-13,Purchase,436653.0,0.0,716657.7
2021-08-13,Tax,6.2,0.0,716663.9
2021-08-13,Cheque,0.0,79629.32,637034.58
2021-08-13,Reversal,54.16,0.0,637088.74
2021-08-13,NEFT,1977976.0,0.0,2615064.74
2021-08-13,Reversal,210892.5,0.0,2825957.24
2021-08-13,Cheque,0.0,282595.72,2543361.52
2021-08-13,Purchase,2.31,0.0,2543363.83
2021-08-13,Bill,0.0,363337.69,2180026.14
2021-08-13,Miscellaneous,4500.0,0.0,2184526.14
2021-08-13,Reversal,21.8,0.0,2184547.94
2021-08-13,Reversal,0.0,242727.55,1941820.39
2021-08-13,Cheque,6.0,0.0,1941826.39
2021-08-13,Debit Card,0.0,194182.64,1747643.75
2021-08-14,Bill,0.0,349528.75,1398115.0
2021-08-14,Cheque,0.0,155346.11,1242768.89
2021-08-14,Transfer,0.0,1242768.89,0.0
2021-08-14,Debit Card,6.35,0.0,6.35
2021-08-14,Debit Card,0.0,0.79,5.56
2021-08-14,Commission,0.0,0.56,5.0
2021-08-14,Miscellaneous,22759.56,0.0,22764.56
2021-08-14,Interest,0.0,2276.46,20488.1
2021-08-14,Cheque,0.0,4097.62,16390.48
2021-08-15,IMPS,0.0,16390.48,0.0
2021-08-15,Cheque,843.0,0.0,843.0
2021-08-15,IMPS,0.0,105.38,737.62
2021-08-15,Bill,2.98,0.0,740.6
2021-08-15,Purchase,1852600.2,0.0,1853340.8
2021-08-15,Reversal,0.0,926670.4,926670.4
2021-08-15,IMPS,0.0,115833.8,810836.6
2021-08-15,Interest,0.0,101354.58,709482.02
2021-08-15,Miscellaneous,106843.0,0.0,816325.02
2021-08-15,RTGS,0.0,408162.51,408162.51
2021-08-15,Reversal,0.0,102040.63,306121.88
2021-08-16,Debit Card,5.7,0.0,306127.58
2021-08-16,IMPS,0.0,34014.18,272113.4
2021-08-16,Debit Card,0.0,90704.47,181408.93
2021-08-16,Transfer,4693.93,0.0,186102.86
2021-08-16,ATM,0.0,62034.29,124068.57
2021-08-16,Bill,0.0,20678.1,103390.48
2021-08-16,Miscellaneous,66391.4,0.0,169781.88
2021-08-16,RTGS,35.38,0.0,169817.26
2021-08-16,Reversal,19.65,0.0,169836.91
2021-08-16,Tax,0.0,56612.3,113224.61
2021-08-16,ATM,187256.8,0.0,300481.41
2021-08-16,Transfer,23.0,0.0,300504.41
2021-08-16,Debit Card,0.0,150252.21,150252.2
2021-08-16,RTGS,0.0,21464.6,128787.6
2021-08-16,Interest,0.0,12878.76,115908.84
2021-08-16,Transfer,0.0,57954.42,57954.42
2021-08-16,IMPS,2825.57,0.0,60779.99
2021-08-16,ATM,0.0,8682.86,52097.13
2021-08-16,Commission,222167.5,0.0,274264.63
2021-08-16,Reversal,0.0,30473.85,243790.78
2021-08-16,Interest,0.0,243790.78,0.0
2021-08-16,Miscellaneous,1297485.2,0.0,1297485.2
2021-08-16,Debit Card,1.0,0.0,1297486.2
2021-08-16,Purchase,0.0,648743.1,648743.1
2021-08-16,Cheque,252991.0,0.0,901734.1
2021-08-16,Miscellaneous,0.0,90173.41,811560.69
2021-08-16,Reversal,2.0,0.0,811562.69
2021-08-16,NEFT,0.0,270520.9,541041.79
2021-08-16,Debit Card,0.0,90173.63,450868.16
2021-08-16,Cash,1877235.0,0.0,2328103.16
2021-08-16,Interest,0.0,291012.9,2037090.26
2021-08-16,Bill,0.0,2037090.26,0.0
2021-08-16,Cheque,250.0,0.0,250.0
2021-08-16,Miscellaneous,11508.85,0.0,11758.85
2021-08-16,Tax,30689.0,0.0,42447.85
2021-08-16,NEFT,0.0,6063.98,36383.87
2021-08-16,Transfer,0.0,4547.98,31835.89
2021-08-16,Reversal,141.5,0.0,31977.39
2021-08-16,Cash,0.0,15988.7,15988.7
2021-08-16,Tax,130.3,0.0,16119.0
2021-08-16,Purchase,0.0,1791.0,14328.0
2021-08-16,Commission,13.5,0.0,14341.5
2021-08-16,Interest,31.0,0.0,14372.5
2021-08-16,Debit Card,0.0,7186.25,7186.25
2021-08-16,Debit Card,0.0,898.28,6287.97
2021-08-16,IMPS,49.5,0.0,6337.47
2021-08-16,ATM,231369.1,0.0,237706.57
2021-08-16,Tax,0.0,33958.08,203748.49
2021-08-16,Commission,486.0,0.0,204234.49
2021-08-16,ATM,664.0,0.0,204898.49
2021-08-16,Tax,422.7,0.0,205321.19
2021-08-16,Cash,1009.56,0.0,206330.75
2021-08-16,RTGS,1.3,0.0,206332.05
2021-08-16,Cheque,170428.66,0.0,376760.71
2021-08-16,Bill,0.0,47095.09,329665.62
2021-08-16,Reversal,164.9,0.0,329830.52
2021-08-16,Purchase,3479.16,0.0,333309.68
2021-08-16,Transfer,0.73,0.0,333310.41
2021-08-16,Bill,202.9,0.0,333513.31
2021-08-16,Commission,0.0,55585.55,277927.76
2021-08-16,IMPS,0.0,39703.97,238223.79
2021-08-16,Interest,0.0,47644.76,190579.03
2021-08-16,Cheque,0.0,27225.58,163353.45
2021-08-16,RTGS,0.0,27225.58,136127.88
2021-08-16,Tax,470.0,0.0,136597.88
2021-08-16,RTGS,0.0,68298.94,68298.94
2021-08-16,Tax,7.0,0.0,68305.94
2021-08-16,IMPS,1.18,0.0,68307.12
2021-08-16,IMPS,428225.5,0.0,496532.62
2021-08-16,Debit Card,3414.8,0.0,499947.42
2021-08-16,Bill,0.0,249973.71,249973.71
2021-08-16,ATM,0.0,24997.37,224976.34
2021-08-16,RTGS,0.0,28122.04,196854.3
2021-08-16,Transfer,347.8,0.0,197202.1
2021-08-16,IMPS,0.0,98601.05,98601.05
2021-08-16,NEFT,0.0,49300.53,49300.52
2021-08-16,ATM,0.0,49300.52,0.0
2021-08-16,NEFT,58.54,0.0,58.54
2021-08-16,Debit Card,17241.0,0.0,17299.54
2021-08-16,Transfer,0.0,4324.89,12974.66
2021-08-16,ATM,499666.5,0.0,512641.16
2021-08-16,Cash,23.2,0.0,512664.36
2021-08-16,Cash,0.0,128166.09,384498.27
2021-08-16,Debit Card,0.0,38449.83,346048.44
2021-08-16,Cheque,0.0,49435.49,296612.95
2021-08-16,Bill,0.0,29661.3,266951.66
2021-08-16,ATM,367.3,0.0,267318.96
2021-08-16,Reversal,3519.21,0.0,270838.17
2021-08-16,Tax,1841.33,0.0,272679.5
2021-08-16,Purchase,0.0,272679.5,0.0
2021-08-16,Commission,0.2,0.0,0.2
2021-08-16,Tax,0.0,0.05,0.15
2021-08-16,Cheque,6.5,0.0,6.65
2021-08-16,Bill,0.0,1.66,4.99
2021-08-16,NEFT,0.0,0.62,4.37
2021-08-16,IMPS,5.7,0.0,10.07
2021-08-16,Tax,0.0,1.26,8.81
2021-08-16,Bill,0.0,0.88,7.93
2021-08-17,Commission,0.0,0.99,6.94
2021-08-17,Reversal,2.51,0.0,9.45
2021-08-17,Reversal,0.0,1.89,7.56
2021-08-17,Cheque,0.0,0.0,7.56
2021-08-17,IMPS,1807427.0,0.0,1807434.56
2021-08-17,Miscellaneous,2114.73,0.0,1809549.29
2021-08-17,RTGS,0.0,226193.66,1583355.63
2021-08-17,Cheque,11643.19,0.0,1594998.82
2021-08-18,Reversal,27.0,0.0,1595025.82
2021-08-18,Cheque,61.3,0.0,1595087.12
2021-08-18,NEFT,25532.7,0.0,1620619.82
2021-08-18,ATM,224670.0,0.0,1845289.82
2021-08-18,IMPS,0.0,263612.83,1581676.99
2021-08-18,Bill,28311.59,0.0,1609988.58
2021-08-18,RTGS,0.0,402497.15,1207491.44
2021-08-18,Bill,2007474.0,0.0,3214965.44
2021-08-18,Interest,8437.1,0.0,3223402.54
2021-08-18,Interest,392.1,0.0,3223794.64
2021-08-18,ATM,0.0,805948.66,2417845.98
2021-08-18,ATM,1.45,0.0,2417847.43
2021-08-18,Interest,0.0,268649.71,2149197.72
2021-08-18,RTGS,2283.26,0.0,2151480.98
2021-08-18,NEFT,32.99,0.0,2151513.97
2021-08-18,ATM,323.0,0.0,2151836.97
2021-08-18,IMPS,0.0,307405.28,1844431.69
2021-08-18,Tax,0.0,368886.34,1475545.35
2021-08-18,Debit Card,0.0,184443.17,1291102.18
2021-08-18,Interest,0.0,258220.44,1032881.74
2021-08-18,Cheque,0.0,147554.53,885327.21
2021-08-18,Reversal,0.0,442663.61,442663.6
2021-08-18,Commission,193866.81,0.0,636530.41
2021-08-18,Cheque,16796.0,0.0,653326.41
2021-08-18,Miscellaneous,0.0,163331.6,489994.81
2021-08-18,Commission,0.0,48999.48,440995.33
2021-08-18,Cash,0.0,220497.67,220497.66
2021-08-18,Purchase,0.0,36749.61,183748.05
2021-08-18,IMPS,5000.0,0.0,188748.05
2021-08-18,Purchase,0.0,31458.01,157290.04
2021-08-19,IMPS,37.3,0.0,157327.34
2021-08-19,Bill,0.0,15732.73,141594.61
2021-08-19,Transfer,6.0,0.0,141600.61
2021-08-19,Cash,878049.75,0.0,1019650.36
2021-08-19,Miscellaneous,0.0,145664.34,873986.02
2021-08-19,Interest,0.0,218496.51,655489.52
2021-08-19,RTGS,15825.0,0.0,671314.52
2021-08-19,NEFT,2229.4,0.0,673543.92
2021-08-19,ATM,0.0,74838.21,598705.71
2021-08-19,Bill,0.0,85529.39,513176.32
2021-08-19,NEFT,442908.0,0.0,956084.32
2021-08-20,Cheque,0.0,239021.08,717063.24
2021-08-20,Commission,425.01,0.0,717488.25
2021-08-20,Tax,0.0,358744.13,358744.12
2021-08-20,Reversal,0.0,35874.41,322869.71
2021-08-20,NEFT,0.0,161434.86,161434.86
2021-08-20,Cheque,26125.4,0.0,187560.26
2021-08-20,Reversal,1101232.0,0.0,1288792.26
2021-08-20,Commission,33.0,0.0,1288825.26
2021-08-20,Purchase,0.0,257765.05,1031060.21
2021-08-20,ATM,0.0,257765.05,773295.16
2021-08-20,Reversal,0.0,128882.53,644412.63
2021-08-20,NEFT,0.0,322206.32,322206.32
2021-08-20,Miscellaneous,0.0,40275.79,281930.53
2021-08-20,Reversal,0.0,40275.79,241654.74
2021-08-21,Interest,2487.8,0.0,244142.54
2021-08-22,Tax,0.0,61035.64,183106.9
2021-08-22,Interest,0.0,22888.36,160218.54
2021-08-22,Tax,38489.19,0.0,198707.73
2021-08-22,ATM,50127.2,0.0,248834.93
2021-08-22,IMPS,0.0,31104.37,217730.56
2021-08-22,Commission,0.0,21773.06,195957.5
2021-08-22,Interest,0.0,195957.5,0.0
2021-08-22,Purchase,86912.0,0.0,86912.0
2021-08-22,Purchase,7.29,0.0,86919.29
2021-08-22,Transfer,0.0,28973.1,57946.19
2021-08-22,Cheque,273.12,0.0,58219.31
2021-08-22,Interest,0.0,29109.66,29109.66
2021-08-22,NEFT,0.0,7277.42,21832.24
2021-08-22,Commission,14883.7,0.0,36715.94
2021-08-22,ATM,49.5,0.0,36765.44
2021-08-22,Cheque,87644.0,0.0,124409.44
2021-08-22,Miscellaneous,0.0,12440.94,111968.5
2021-08-22,Commission,0.0,18661.42,93307.08
2021-08-22,RTGS,493.0,0.0,93800.08
2021-08-22,Interest,0.0,13400.01,80400.07
2021-08-22,RTGS,196411.88,0.0,276811.95
2021-08-22,Debit Card,27.99,0.0,276839.94
2021-08-22,Commission,0.0,276839.94,0.0
2021-08-22,ATM,1053768.0,0.0,1053768.0
2021-08-22,Transfer,501.65,0.0,1054269.65
2021-08-22,Transfer,0.0,263567.41,790702.24
2021-08-22,Cheque,43377.0,0.0,834079.24
2021-08-22,Reversal,1095.5,0.0,835174.74
2021-08-22,RTGS,0.0,83517.47,751657.27
2021-08-22,Debit Card,0.0,375828.64,375828.64
2021-08-22,RTGS,0.0,187914.32,187914.32
2021-08-22,ATM,0.0,18791.43,169122.89
2021-08-22,Miscellaneous,281.0,0.0,169403.89
2021-08-22,RTGS,4.0,0.0,169407.89
2021-08-22,Cash,0.0,84703.95,84703.94
2021-08-22,Reversal,361.0,0.0,85064.94
2021-08-22,Debit Card,187.36,0.0,85252.3
2021-08-22,RTGS,2.0,0.0,85254.3
2021-08-22,RTGS,0.0,10656.79,74597.51
2021-08-22,Purchase,0.0,37298.76,37298.75
2021-08-22,Debit Card,0.0,5328.39,31970.36
2021-08-22,Purchase,944.0,0.0,32914.36
2021-08-22,Cash,255.6,0.0,33169.96
2021-08-22,Reversal,7.96,0.0,33177.92
2021-08-22,Bill,0.0,6635.58,26542.34
2021-08-22,Miscellaneous,0.0,4423.72,22118.62
2021-08-22,ATM,0.0,3159.8,18958.82
2021-08-22,Commission,2523.7,0.0,21482.52
2021-08-22,Cash,0.0,5370.63,16111.89
2021-08-22,Interest,205.3,0.0,16317.19
2021-08-22,Miscellaneous,0.0,3263.44,13053.75
2021-08-22,Debit Card,0.0,3263.44,9790.31
2021-08-22,ATM,476.73,0.0,10267.04
2021-08-22,Commission,3899.2,0.0,14166.24
2021-08-22,ATM,0.0,14166.24,0.0
2021-08-22,Transfer,656096.0,0.0,656096.0
2021-08-22,Interest,0.0,328048.0,328048.0
2021-08-22,Commission,0.0,46864.0,281184.0
2021-08-22,RTGS,34.81,0.0,281218.81
2021-08-22,IMPS,1729.0,0.0,282947.81
2021-08-22,Purchase,251149.62,0.0,534097.43
2021-08-22,IMPS,2.0,0.0,534099.43
2021-08-22,Purchase,3957.0,0.0,538056.43
2021-08-22,IMPS,751814.2,0.0,1289870.63
2021-08-22,IMPS,0.0,161233.83,1128636.8
2021-08-22,Commission,1890083.8,0.0,3018720.6
2021-08-22,Cash,1769849.5,0.0,4788570.1
2021-08-23,ATM,0.0,532063.34,4256506.76
2021-08-23,RTGS,0.0,532063.35,3724443.42
2021-08-23,NEFT,242.0,0.0,3724685.42
2021-08-23,IMPS,4.9,0.0,3724690.32
2021-08-23,IMPS,0.0,1862345.16,1862345.16
2021-08-23,Tax,31262.7,0.0,1893607.86
2021-08-23,Reversal,0.0,1893607.86,0.0
2021-08-23,Bill,6802.0,0.0,6802.0
2021-08-23,Reversal,21101.2,0.0,27903.2
2021-08-23,Debit Card,7.7,0.0,27910.9
2021-08-23,Cash,2846.56,0.0,30757.46
2021-08-23,Miscellaneous,0.0,7689.37,23068.1
2021-08-23,Purchase,0.0,7689.37,15378.73
2021-08-23,RTGS,49316.0,0.0,64694.73
2021-08-23,Bill,160694.0,0.0,225388.73
2021-08-23,Cheque,24773.0,0.0,250161.73
2021-08-23,Tax,0.0,125080.87,125080.86
2021-08-23,Commission,0.0,41693.62,83387.24
2021-08-23,Miscellaneous,0.0,8338.72,75048.52
2021-08-23,Debit Card,0.0,15009.7,60038.82
2021-08-23,Transfer,23142.0,0.0,83180.82
2021-08-23,Interest,0.0,20795.21,62385.62
2021-08-23,Commission,0.0,31192.81,31192.81
2021-08-23,Debit Card,1635900.0,0.0,1667092.81
2021-08-23,Debit Card,24696.4,0.0,1691789.21
2021-08-23,ATM,0.0,211473.65,1480315.56
2021-08-23,ATM,0.0,246719.26,1233596.3
2021-08-23,Interest,0.0,411198.77,822397.53
2021-08-23,Reversal,0.0,137066.26,685331.28
2021-08-23,Tax,4.8,0.0,685336.08
2021-08-23,Cash,25528.9,0.0,710864.98
2021-08-23,IMPS,0.0,710864.98,0.0
2021-08-23,Cheque,1339.63,0.0,1339.63
2021-08-23,Cheque,0.0,167.45,1172.18
2021-08-23,Miscellaneous,0.0,586.09,586.09
2021-08-23,Miscellaneous,81586.0,0.0,82172.09
2021-08-23,Tax,27768.5,0.0,109940.59
2021-08-23,Commission,178768.8,0.0,288709.39
2021-08-23,Tax,36.0,0.0,288745.39
2021-08-23,RTGS,1.0,0.0,288746.39
2021-08-23,Bill,0.0,32082.93,256663.46
2021-08-23,Bill,0.0,32082.93,224580.53
2021-08-23,Miscellaneous,137830.59,0.0,362411.12
2021-08-23,ATM,0.0,60401.85,302009.27
2021-08-23,Transfer,0.0,151004.64,151004.64
2021-08-23,Commission,50.0,0.0,151054.64
2021-08-23,Debit Card,0.0,15105.46,135949.18
2021-08-23,Purchase,0.0,22658.2,113290.98
2021-08-23,Transfer,0.0,18881.83,94409.15
2021-08-23,Debit Card,0.0,15734.86,78674.29
2021-08-23,IMPS,0.0,9834.29,68840.0
2021-08-23,ATM,173240.5,0.0,242080.5
2021-08-23,Miscellaneous,907280.2,0.0,1149360.7
2021-08-23,Tax,0.0,287340.18,862020.52
2021-08-23,Bill,0.0,107752.57,754267.96
2021-08-24,Reversal,3.31,0.0,754271.27
2021-08-24,Miscellaneous,3126.0,0.0,757397.27
2021-08-24,ATM,0.0,252465.76,504931.51
2021-08-24,Bill,36.8,0.0,504968.31
2021-08-24,Commission,7368.23,0.0,512336.54
2021-08-24,Purchase,98.0,0.0,512434.54
2021-08-24,Tax,470.0,0.0,512904.54
2021-08-24,Transfer,1781076.0,0.0,2293980.54
2021-08-24,Transfer,0.0,382330.09,1911650.45
2021-08-24,Debit Card,244891.0,0.0,2156541.45
2021-08-24,Interest,0.0,2156541.45,0.0
2021-08-24,NEFT,10.8,0.0,10.8
2021-08-24,ATM,0.0,1.8,9.0
2021-08-24,IMPS,399.4,0.0,408.4
2021-08-24,NEFT,4.38,0.0,412.78
2021-08-24,Tax,3.0,0.0,415.78
2021-08-24,Interest,0.0,138.59,277.19
2021-08-24,Tax,0.0,69.3,207.89
2021-08-24,Commission,32.73,0.0,240.62
2021-08-24,NEFT,0.0,26.74,213.88
2021-08-24,Commission,0.0,213.88,0.0
2021-08-24,Transfer,1750338.0,0.0,1750338.0
2021-08-24,ATM,750164.0,0.0,2500502.0
2021-08-24,Debit Card,481.74,0.0,2500983.74
2021-08-24,Debit Card,0.0,312622.97,2188360.77
2021-08-24,Miscellaneous,0.0,364726.8,1823633.98
2021-08-24,Commission,16069.0,0.0,1839702.98
2021-08-24,Commission,8.0,0.0,1839710.98
2021-08-24,NEFT,0.0,262815.85,1576895.13
2021-08-24,Purchase,7931.0,0.0,1584826.13
2021-08-24,Cash,0.0,198103.27,1386722.86
2021-08-24,Cheque,53.4,0.0,1386776.26
2021-08-24,Cash,0.0,198110.89,1188665.37
2021-08-24,Purchase,0.0,118866.54,1069798.83
2021-08-24,IMPS,64.0,0.0,1069862.83
2021-08-24,Debit Card,0.0,267465.71,802397.12
2021-08-24,Purchase,0.0,89155.24,713241.88
2021-08-24,Cheque,0.0,356620.94,356620.94
2021-08-24,Debit Card,0.0,71324.19,285296.75
2021-08-24,RTGS,0.0,31699.64,253597.11
2021-08-24,ATM,0.0,25359.71,228237.4
2021-08-24,Debit Card,0.0,45647.48,182589.92
2021-08-24,Debit Card,0.0,45647.48,136942.44
2021-08-24,Transfer,0.0,68471.22,68471.22
2021-08-24,Interest,112.9,0.0,68584.12
2021-08-24,Cheque,0.0,6858.41,61725.71
2021-08-24,Reversal,0.0,15431.43,46294.28
2021-08-24,Interest,26.4,0.0,46320.68
2021-08-24,ATM,98.0,0.0,46418.68
2021-08-24,Miscellaneous,0.0,4641.87,41776.81
2021-08-24,RTGS,212.0,0.0,41988.81
2021-08-24,NEFT,0.0,10497.2,31491.61
2021-08-24,IMPS,2313.0,0.0,33804.61
2021-08-24,NEFT,6503.41,0.0,40308.02
2021-08-24,Cash,134374.0,0.0,174682.02
2021-08-24,NEFT,13.18,0.0,174695.2
2021-08-24,Bill,6801.0,0.0,181496.2
2021-08-24,NEFT,5.6,0.0,181501.8
2021-08-24,Tax,0.0,20166.87,161334.93
2021-08-24,Transfer,0.0,16133.49,145201.44
2021-08-24,Transfer,0.0,145201.44,0.0
2021-08-24,Bill,452.83,0.0,452.83
2021-08-24,Bill,0.0,90.57,362.26
2021-08-24,Commission,7.53,0.0,369.79
2021-08-24,Purchase,0.0,123.26,246.53
2021-08-24,Tax,0.0,61.63,184.9
2021-08-24,NEFT,0.0,20.54,164.36
2021-08-24,Tax,161.59,0.0,325.95
2021-08-24,Bill,246999.8,0.0,247325.75
2021-08-24,ATM,28004.8,0.0,275330.55
2021-08-24,Commission,0.0,27533.06,247797.5
2021-08-24,RTGS,0.0,41299.58,206497.92
2021-08-24,Bill,831.0,0.0,207328.92
2021-08-24,Miscellaneous,1030153.25,0.0,1237482.17
2021-08-24,Debit Card,0.0,247496.43,989985.74
2021-08-24,Reversal,0.0,989985.74,0.0
2021-08-24,IMPS,245458.56,0.0,245458.56
2021-08-24,Tax,8270.2,0.0,253728.76
2021-08-24,Cash,0.0,36246.97,217481.79
2021-08-24,RTGS,144.8,0.0,217626.59
2021-08-24,Bill,0.0,72542.2,145084.39
2021-08-24,Debit Card,543151.0,0.0,688235.39
2021-08-24,Cash,0.0,68823.54,619411.85
2021-08-24,Purchase,0.0,68823.54,550588.31
2021-08-24,Tax,0.0,61176.48,489411.83
2021-08-24,Purchase,61.3,0.0,489473.13
2021-08-24,Debit Card,0.0,48947.31,440525.82
2021-08-24,IMPS,0.0,73420.97,367104.85
2021-08-24,Bill,52.65,0.0,367157.5
2021-08-24,Tax,3578.9,0.0,370736.4
2021-08-24,Cash,0.0,92684.1,278052.3
2021-08-24,Interest,0.0,27805.23,250247.07
2021-08-24,ATM,0.0,27805.23,222441.84
2021-08-24,Commission,28795.0,0.0,251236.84
2021-08-24,Cheque,61807.2,0.0,313044.04
2021-08-24,Interest,1060.0,0.0,314104.04
2021-08-24,Reversal,0.0,39263.01,274841.03
2021-08-24,Cheque,6.8,0.0,274847.83
2021-08-24,Interest,0.0,39263.98,235583.85
2021-08-24,Reversal,0.0,39263.98,196319.88
2021-08-24,Commission,0.0,98159.94,98159.94
2021-08-25,Interest,0.0,10906.66,87253.28
2021-08-25,IMPS,23342.0,0.0,110595.28
2021-08-25,Commission,0.0,13824.41,96770.87
2021-08-25,Transfer,3729.0,0.0,100499.87
2021-08-25,Debit Card,3854.81,0.0,104354.68
2021-08-25,IMPS,0.0,104354.68,0.0
2021-08-25,Tax,183.1,0.0,183.1
2021-08-25,Commission,129245.56,0.0,129428.66
2021-08-25,Interest,1154596.25,0.0,1284024.91
2021-08-25,RTGS,0.0,256804.98,1027219.93
2021-08-25,Interest,0.0,128402.49,898817.44
2021-08-25,Tax,20061.0,0.0,918878.44
2021-08-25,Transfer,43817.0,0.0,962695.44
2021-08-25,ATM,0.0,481347.72,481347.72
2021-08-25,Reversal,1.0,0.0,481348.72
2021-08-25,RTGS,5.0,0.0,481353.72
2021-08-25,Purchase,0.0,53483.75,427869.97
2021-08-25,ATM,143643.5,0.0,571513.47
2021-08-25,Cheque,0.0,81644.78,489868.69
2021-08-25,Transfer,0.0,122467.17,367401.52
2021-08-25,Miscellaneous,0.0,45925.19,321476.33
2021-08-25,Commission,0.0,35719.59,285756.74
2021-08-25,Interest,0.0,31750.75,254005.99
2021-08-25,Purchase,215235.0,0.0,469240.99
2021-08-25,Transfer,1401456.25,0.0,1870697.24
2021-08-25,Purchase,0.0,233837.16,1636860.08
2021-08-25,Purchase,0.0,818430.04,818430.04
2021-08-25,IMPS,5.9,0.0,818435.94
2021-08-25,Purchase,655379.25,0.0,1473815.19
2021-08-25,Bill,0.0,147381.52,1326433.67
2021-08-26,Bill,31255.0,0.0,1357688.67
2021-08-26,Miscellaneous,0.0,452562.89,905125.78
2021-08-26,Cash,0.0,452562.89,452562.89
2021-08-26,Bill,0.0,56570.36,395992.53
2021-08-26,Debit Card,27.61,0.0,396020.14
2021-08-26,Cheque,226737.2,0.0,622757.34
2021-08-26,Bill,0.0,103792.89,518964.45
2021-08-26,Bill,0.0,51896.45,467068.0
2021-08-26,Cheque,0.0,46706.8,420361.2
2021-08-26,Commission,328.0,0.0,420689.2
2021-08-26,ATM,18242.94,0.0,438932.14
2021-08-26,Transfer,0.0,109733.04,329199.1
2021-08-26,ATM,173815.2,0.0,503014.3
2021-08-26,Debit Card,244627.9,0.0,747642.2
2021-08-26,NEFT,0.0,186910.55,560731.65
2021-08-26,Commission,12466.0,0.0,573197.65
2021-08-26,Cheque,0.0,71649.71,501547.94
2021-08-26,Bill,3193.0,0.0,504740.94
2021-08-26,Cheque,0.0,72105.85,432635.09
2021-08-26,IMPS,30422.81,0.0,463057.9
2021-08-26,ATM,0.0,92611.58,370446.32
2021-08-26,Purchase,3.0,0.0,370449.32
2021-08-26,Commission,776.51,0.0,371225.83
2021-08-26,Bill,0.0,37122.58,334103.25
2021-08-26,Interest,0.0,66820.65,267282.6
2021-08-26,Miscellaneous,0.0,33410.33,233872.27
2021-08-26,Miscellaneous,0.0,58468.07,175404.2
2021-08-26,Interest,0.0,21925.53,153478.68
2021-08-26,Miscellaneous,4014.0,0.0,157492.68
2021-08-26,Purchase,0.0,157492.68,0.0
2021-08-26,Interest,1862.0,0.0,1862.0
2021-08-26,Bill,45.0,0.0,1907.0
2021-08-26,RTGS,0.0,953.5,953.5
2021-08-26,Interest,0.0,953.5,0.0
2021-08-26,Transfer,41.0,0.0,41.0
2021-08-26,NEFT,0.0,6.83,34.17
2021-08-26,IMPS,0.0,8.54,25.63
2021-08-26,Tax,1712353.5,0.0,1712379.13
2021-08-26,Cheque,59.8,0.0,1712438.93
2021-08-26,Tax,0.0,171243.89,1541195.04
2021-08-26,Reversal,174159.8,0.0,1715354.84
2021-08-26,Debit Card,8.2,0.0,1715363.04
2021-08-26,Interest,0.0,1715363.04,0.0
2021-08-26,Bill,782.0,0.0,782.0
2021-08-26,Tax,2756.41,0.0,3538.41
2021-08-26,Commission,3845.0,0.0,7383.41
2021-08-26,Tax,167438.91,0.0,174822.32
2021-08-26,Reversal,19.28,0.0,174841.6
2021-08-26,Reversal,1482692.75,0.0,1657534.35
2021-08-26,Tax,3718.0,0.0,1661252.35
2021-08-26,Commission,0.0,830626.18,830626.18
2021-08-26,NEFT,3621.27,0.0,834247.45
2021-08-26,Purchase,0.0,166849.49,667397.96
2021-08-26,Reversal,7.2,0.0,667405.16
2021-08-26,Transfer,0.0,74156.13,593249.03
2021-08-26,Purchase,0.0,118649.81,474599.22
2021-08-26,Purchase,190.97,0.0,474790.19
2021-08-26,Miscellaneous,127193.0,0.0,601983.19
2021-08-26,NEFT,25694.5,0.0,627677.69
2021-08-26,Cash,0.0,627677.69,0.0
2021-08-26,Tax,172.0,0.0,172.0
2021-08-26,NEFT,0.0,34.4,137.6
2021-08-26,Purchase,765.1,0.0,902.7
2021-08-26,Cash,17052.7,0.0,17955.4
2021-08-26,IMPS,32327.3,0.0,50282.7
2021-08-26,Reversal,0.0,16760.9,33521.8
2021-08-26,Debit Card,0.0,16760.9,16760.9
2021-08-26,ATM,654328.0,0.0,671088.9
2021-08-26,Transfer,0.0,167772.23,503316.68
2021-08-26,Purchase,1080377.5,0.0,1583694.18
2021-08-26,ATM,2047593.2,0.0,3631287.38
2021-08-26,ATM,0.0,453910.92,3177376.46
2021-08-26,Reversal,0.0,1588688.23,1588688.23
2021-08-26,Bill,0.0,198586.03,1390102.2
2021-08-26,Cheque,2839.0,0.0,1392941.2
2021-08-26,Cheque,5.1,0.0,1392946.3
2021-08-26,Miscellaneous,288.0,0.0,1393234.3
2021-08-26,IMPS,194.0,0.0,1393428.3
2021-08-26,Transfer,23008.0,0.0,1416436.3
2021-08-26,Cheque,1475609.0,0.0,2892045.3
2021-08-26,Transfer,308.9,0.0,2892354.2
2021-08-26,Purchase,213449.3,0.0,3105803.5
2021-08-26,Bill,60.82,0.0,3105864.32
2021-08-26,Commission,10.56,0.0,3105874.88
2021-08-26,Commission,0.0,517645.81,2588229.07
2021-08-26,Reversal,2064.0,0.0,2590293.07
2021-08-26,NEFT,121222.66,0.0,2711515.73
2021-08-26,Cash,0.0,1355757.87,1355757.86
2021-08-26,Reversal,32.3,0.0,1355790.16
2021-08-26,RTGS,41.0,0.0,1355831.16
2021-08-26,Interest,0.0,150647.91,1205183.25
2021-08-26,IMPS,0.0,301295.81,903887.44
2021-08-26,Purchase,0.0,90388.74,813498.7
2021-08-26,IMPS,0.0,116214.1,697284.6
2021-08-26,Bill,1612507.2,0.0,2309791.8
2021-08-27,Commission,0.0,1154895.9,1154895.9
2021-08-27,Reversal,0.0,577447.95,577447.95
2021-08-27,Debit Card,0.0,96241.33,481206.62
2021-08-27,Interest,32.24,0.0,481238.86
2021-08-27,Transfer,0.0,60154.86,421084.0
2021-08-27,Cheque,5.82,0.0,421089.82
2021-08-27,IMPS,2912.0,0.0,424001.82
2021-08-27,Commission,803841.0,0.0,1227842.82
2021-08-27,Cheque,0.0,1227842.82,0.0
2021-08-27,Tax,59.17,0.0,59.17
2021-08-27,Commission,66.0,0.0,125.17
2021-08-27,Miscellaneous,0.0,31.29,93.88
2021-08-27,Debit Card,969030.0,0.0,969123.88
2021-08-27,Bill,0.0,969123.88,0.0
2021-08-27,Bill,0.0,0.0,0.0
2021-08-27,Transfer,1300.0,0.0,1300.0
2021-08-27,IMPS,0.0,325.0,975.0
2021-08-27,ATM,0.0,325.0,650.0
2021-08-27,Miscellaneous,128.0,0.0,778.0
2021-08-27,Debit Card,480.0,0.0,1258.0
2021-08-27,Bill,17072.9,0.0,18330.9
2021-08-27,Commission,1888.8,0.0,20219.7
2021-08-27,ATM,0.0,2021.97,18197.73
2021-08-27,Cash,53.0,0.0,18250.73
2021-08-27,Miscellaneous,1660455.0,0.0,1678705.73
2021-08-27,RTGS,0.0,279784.29,1398921.44
2021-08-27,Debit Card,0.0,1398921.44,0.0
2021-08-27,ATM,60826.03,0.0,60826.03
2021-08-27,IMPS,0.0,15206.51,45619.52
2021-08-27,NEFT,288.16,0.0,45907.68
2021-08-27,RTGS,0.0,11476.92,34430.76
2021-08-27,Interest,225.9,0.0,34656.66
2021-08-27,Purchase,0.0,6931.33,27725.33
2021-08-27,Miscellaneous,3.31,0.0,27728.64
2021-08-27,IMPS,6.2,0.0,27734.84
2021-08-27,Cash,11290.8,0.0,39025.64
2021-08-27,RTGS,46.0,0.0,39071.64
2021-08-27,Debit Card,22.0,0.0,39093.64
2021-08-27,Reversal,0.0,19546.82,19546.82
2021-08-27,Tax,237107.2,0.0,256654.02
2021-08-27,Miscellaneous,0.0,36664.86,219989.16
2021-08-27,ATM,0.0,54997.29,164991.87
2021-08-27,Tax,0.0,82495.94,82495.94
2021-08-27,Debit Card,0.0,11785.13,70710.81
2021-08-27,Tax,112516.0,0.0,183226.81
2021-08-27,Bill,0.0,18322.68,164904.13
2021-08-27,NEFT,0.0,27484.02,137420.11
2021-08-27,Cash,120.0,0.0,137540.11
2021-08-27,NEFT,0.0,13754.01,123786.1
2021-08-27,ATM,1297.0,0.0,125083.1
2021-08-28,Bill,0.0,12508.31,112574.79
2021-08-28,Debit Card,0.0,12508.31,100066.48
2021-08-28,RTGS,2876.5,0.0,102942.98
2021-08-28,Debit Card,1987743.8,0.0,2090686.78
2021-08-28,Bill,0.0,2090686.78,0.0
2021-08-28,Debit Card,2835.7,0.0,2835.7
2021-08-28,Reversal,0.0,2835.7,0.0
2021-08-28,Cheque,66042.0,0.0,66042.0
2021-08-28,Commission,1433.91,0.0,67475.91
2021-08-28,Cash,184941.0,0.0,252416.91
2021-08-28,Transfer,0.0,25241.69,227175.22
2021-08-28,Bill,0.0,22717.52,204457.7
2021-08-28,IMPS,27.34,0.0,204485.04
2021-08-28,Bill,3237.0,0.0,207722.04
2021-08-28,IMPS,0.0,103861.02,103861.02
2021-08-28,Debit Card,0.0,17310.17,86550.85
2021-08-28,Debit Card,21548.6,0.0,108099.45
2021-08-28,Transfer,29.0,0.0,108128.45
2021-08-28,Cash,0.0,12014.27,96114.18
2021-08-28,Transfer,232869.47,0.0,328983.65
2021-08-29,Reversal,5.0,0.0,328988.65
2021-08-29,RTGS,148.45,0.0,329137.1
2021-08-29,Purchase,0.0,82284.28,246852.82
2021-08-29,Cheque,364.0,0.0,247216.82
2021-08-29,Commission,2008.0,0.0,249224.82
2021-08-29,RTGS,4.0,0.0,249228.82
2021-08-29,ATM,0.0,83076.27,166152.55
2021-08-29,Purchase,46.6,0.0,166199.15
2021-08-29,Cheque,3303.7,0.0,169502.85
2021-08-29,Miscellaneous,53210.9,0.0,222713.75
2021-08-29,Tax,0.0,74237.92,148475.83
2021-08-29,Commission,2596.0,0.0,151071.83
2021-08-29,NEFT,0.0,18883.98,132187.85
2021-08-29,RTGS,11386.0,0.0,143573.85
2021-08-29,Debit Card,0.0,28714.77,114859.08
2021-08-29,Tax,3080.0,0.0,117939.08
2021-08-29,Miscellaneous,0.0,19656.51,98282.57
2021-08-29,NEFT,0.0,12285.32,85997.25
2021-08-29,Miscellaneous,0.0,10749.66,75247.59
2021-08-29,Cash,0.0,18811.9,56435.69
2021-08-29,Debit Card,0.0,11287.14,45148.55
2021-08-29,Transfer,0.0,45148.55,0.0
2021-08-29,ATM,1633122.0,0.0,1633122.0
2021-08-29,IMPS,51.79,0.0,1633173.79
2021-08-29,Interest,4.4,0.0,1633178.19
2021-08-29,Transfer,36.0,0.0,1633214.19
2021-08-29,Transfer,54.8,0.0,1633268.99
2021-08-29,IMPS,15.0,0.0,1633283.99
2021-08-29,IMPS,0.0,163328.4,1469955.59
2021-08-29,ATM,0.0,244992.6,1224962.99
2021-08-29,Purchase,0.0,122496.3,1102466.69
2021-08-29,Cash,68.0,0.0,1102534.69
2021-08-29,Debit Card,0.0,137816.84,964717.85
2021-08-29,Cheque,0.0,321572.62,643145.23
2021-08-29,Interest,0.0,80393.15,562752.08
2021-08-29,Debit Card,0.0,62528.01,500224.07
2021-08-30,Transfer,0.0,50022.41,450201.66
2021-08-30,Purchase,30.0,0.0,450231.66
2021-08-30,Tax,0.0,56278.96,393952.7
2021-08-30,ATM,1930826.0,0.0,2324778.7
2021-08-30,Commission,1986.0,0.0,2326764.7
2021-08-30,Cash,0.0,232676.47,2094088.23
2021-08-30,NEFT,0.0,1047044.12,1047044.12
2021-08-30,Interest,3787.0,0.0,1050831.12
2021-08-30,Tax,0.0,350277.04,700554.08
2021-08-30,Interest,2.0,0.0,700556.08
2021-08-30,Cash,0.0,116759.35,583796.73
2021-08-30,ATM,5.0,0.0,583801.73
2021-08-30,Commission,0.0,291900.87,291900.86
2021-08-30,RTGS,0.0,32433.43,259467.43
2021-08-30,Reversal,175478.0,0.0,434945.43
2021-08-30,IMPS,0.0,62135.06,372810.37
2021-08-30,Miscellaneous,59.0,0.0,372869.37
2021-08-30,Interest,0.0,37286.94,335582.43
2021-08-30,Bill,318.1,0.0,335900.53
2021-08-30,Debit Card,8.0,0.0,335908.53
2021-08-30,RTGS,123595.0,0.0,459503.53
2021-08-30,Interest,0.0,76583.92,382919.61
2021-08-30,NEFT,233.65,0.0,383153.26
2021-08-30,ATM,2.36,0.0,383155.62
2021-08-30,Tax,3.0,0.0,383158.62
2021-08-30,Interest,31.4,0.0,383190.02
2021-08-30,Bill,6.0,0.0,383196.02
2021-08-30,Debit Card,0.0,42577.34,340618.68
2021-08-30,IMPS,0.0,68123.74,272494.94
2021-08-30,Cheque,21417.5,0.0,293912.44
2021-08-30,ATM,50.0,0.0,293962.44
2021-08-30,Cheque,0.0,58792.49,235169.95
2021-08-30,Cheque,0.0,78389.98,156779.97
2021-08-30,ATM,889572.0,0.0,1046351.97
2021-08-30,Commission,0.0,149478.85,896873.12
2021-08-30,IMPS,0.0,179374.62,717498.5
2021-08-30,ATM,0.0,179374.63,538123.88
2021-08-30,Purchase,9688.1,0.0,547811.98
2021-08-30,Commission,96.0,0.0,547907.98
2021-08-30,Commission,0.0,54790.8,493117.18
2021-08-30,Bill,17.0,0.0,493134.18
2021-08-31,Commission,0.0,123283.55,369850.64
2021-08-31,Miscellaneous,0.0,52835.81,317014.83
2021-08-31,IMPS,0.0,79253.71,237761.12
2021-08-31,Cheque,0.0,33965.87,203795.25
2021-08-31,RTGS,0.0,25474.41,178320.84
2021-08-31,Purchase,0.0,35664.17,142656.67
2021-08-31,RTGS,1742874.75,0.0,1885531.42
2021-09-01,Reversal,0.0,269361.63,1616169.79
2021-09-01,RTGS,0.0,808084.9,808084.9
2021-09-01,Cheque,0.0,269361.63,538723.27
2021-09-01,Reversal,0.0,538723.27,0.0
2021-09-02,NEFT,3924.0,0.0,3924.0
2021-09-02,RTGS,0.0,981.0,2943.0
2021-09-02,Reversal,0.0,420.43,2522.57
2021-09-02,Purchase,14809.5,0.0,17332.07
2021-09-02,Reversal,0.0,2166.51,15165.56
2021-09-02,RTGS,7.0,0.0,15172.56
2021-09-02,IMPS,7.0,0.0,15179.56
2021-09-02,Reversal,1462900.0,0.0,1478079.56
2021-09-02,IMPS,103689.2,0.0,1581768.76
2021-09-02,IMPS,34559.2,0.0,1616327.96
2021-09-02,Tax,144755.0,0.0,1761082.96
2021-09-02,Tax,12317.0,0.0,1773399.96
2021-09-02,Tax,0.0,1773399.96,0.0
2021-09-02,ATM,6.0,0.0,6.0
2021-09-02,NEFT,0.0,0.86,5.14
2021-09-02,Interest,0.0,1.29,3.85
2021-09-02,Transfer,74.0,0.0,77.85
2021-09-02,Cheque,0.0,7.79,70.06
2021-09-02,Debit Card,59749.0,0.0,59819.06
2021-09-02,Tax,0.0,11963.81,47855.25
2021-09-02,Commission,156811.0,0.0,204666.25
2021-09-02,IMPS,79756.28,0.0,284422.53
2021-09-02,Purchase,0.0,40631.79,243790.74
2021-09-02,Miscellaneous,0.0,40631.79,203158.95
2021-09-02,RTGS,0.0,29022.71,174136.24
2021-09-02,Debit Card,0.0,174136.24,0.0
2021-09-02,Purchase,30557.0,0.0,30557.0
2021-09-02,Tax,0.0,4365.29,26191.71
2021-09-02,Reversal,183.3,0.0,26375.01
2021-09-02,Miscellaneous,27.0,0.0,26402.01
2021-09-03,ATM,2.76,0.0,26404.77
2021-09-03,Debit Card,0.0,2640.48,23764.29
2021-09-03,Reversal,197665.0,0.0,221429.29
2021-09-03,Transfer,0.0,22142.93,199286.36
2021-09-03,Purchase,59202.6,0.0,258488.96
2021-09-03,Debit Card,0.0,51697.79,206791.17
2021-09-03,Interest,0.0,25848.9,180942.27
2021-09-03,Cheque,39.0,0.0,180981.27
2021-09-03,RTGS,0.0,45245.32,135735.95
2021-09-03,RTGS,0.0,22622.66,113113.29
2021-09-03,Commission,3.0,0.0,113116.29
2021-09-03,Purchase,124338.0,0.0,237454.29
2021-09-03,Miscellaneous,1641.65,0.0,239095.94
2021-09-03,Tax,0.0,59773.99,179321.96
2021-09-03,Tax,156.15,0.0,179478.11
2021-09-03,NEFT,0.0,59826.04,119652.07
2021-09-03,Reversal,297.1,0.0,119949.17
2021-09-03,Debit Card,0.0,23989.83,95959.34
2021-09-03,Transfer,0.0,13708.48,82250.86
2021-09-03,Commission,0.0,13708.48,68542.38
2021-09-03,Reversal,0.0,68542.38,0.0
2021-09-03,Cheque,8.9,0.0,8.9
2021-09-03,Transfer,0.0,0.89,8.01
2021-09-03,ATM,0.0,0.8,7.21
2021-09-03,Transfer,0.0,2.4,4.81
2021-09-03,Tax,0.0,2.41,2.4
2021-09-03,Tax,38281.7,0.0,38284.1
2021-09-03,Debit Card,2372.0,0.0,40656.1
2021-09-03,Interest,1714487.0,0.0,1755143.1
2021-09-03,Bill,30785.17,0.0,1785928.27
2021-09-03,RTGS,0.0,223241.03,1562687.24
2021-09-03,Commission,5.0,0.0,1562692.24
2021-09-03,Miscellaneous,1521346.0,0.0,3084038.24
2021-09-03,Commission,94499.72,0.0,3178537.96
2021-09-03,Miscellaneous,39.0,0.0,3178576.96
2021-09-03,Cheque,59.97,0.0,3178636.93
2021-09-03,Cheque,29335.7,0.0,3207972.63
2021-09-03,Tax,0.0,3207972.63,0.0
2021-09-03,Transfer,513.43,0.0,513.43
2021-09-03,NEFT,0.0,128.36,385.07
2021-09-03,Reversal,2929.36,0.0,3314.43
2021-09-03,Bill,8468.47,0.0,11782.9
2021-09-03,RTGS,0.0,1178.29,10604.61
2021-09-03,RTGS,3.4,0.0,10608.01
2021-09-03,Interest,0.0,1768.0,8840.01
2021-09-03,Interest,339.67,0.0,9179.68
2021-09-04,Tax,0.0,1311.38,7868.3
2021-09-04,Debit Card,0.0,1311.38,6556.92
2021-09-04,NEFT,4052.7,0.0,10609.62
2021-09-04,NEFT,0.0,2652.41,7957.22
2021-09-04,Miscellaneous,0.0,1326.2,6631.02
2021-09-04,Cash,0.0,6631.02,0.0
2021-09-04,Reversal,66651.12,0.0,66651.12
2021-09-04,Reversal,0.0,7405.68,59245.44
2021-09-04,Transfer,2820.0,0.0,62065.44
2021-09-04,Transfer,0.0,6206.54,55858.9
2021-09-04,Miscellaneous,0.0,27929.45,27929.45
2021-09-04,IMPS,6.3,0.0,27935.75
2021-09-04,RTGS,0.0,3491.97,24443.78
2021-09-04,ATM,508.48,0.0,24952.26
2021-09-04,Commission,228449.88,0.0,253402.14
2021-09-04,Debit Card,0.0,63350.54,190051.6
2021-09-04,Bill,172220.1,0.0,362271.7
2021-09-04,Reversal,75871.03,0.0,438142.73
2021-09-04,Commission,0.95,0.0,438143.68
2021-09-04,Bill,2759.0,0.0,440902.68
2021-09-04,IMPS,576443.5,0.0,1017346.18
2021-09-04,Cash,25331.0,0.0,1042677.18
2021-09-04,Debit Card,1724.9,0.0,1044402.08
2021-09-04,Reversal,4245.1,0.0,1048647.18
2021-09-04,IMPS,2780.6,0.0,1051427.78
2021-09-04,Reversal,6.4,0.0,1051434.18
2021-09-04,Debit Card,3241.78,0.0,1054675.96
2021-09-04,Transfer,0.0,105467.6,949208.36
2021-09-04,Debit Card,5609.0,0.0,954817.36
2021-09-04,Reversal,197144.0,0.0,1151961.36
2021-09-05,Commission,51423.38,0.0,1203384.74
2021-09-05,Commission,95853.84,0.0,1299238.58
2021-09-05,Purchase,6.0,0.0,1299244.58
2021-09-05,Purchase,0.0,144360.51,1154884.07
2021-09-06,Cash,3.5,0.0,1154887.57
2021-09-06,Reversal,0.0,115488.76,1039398.81
2021-09-06,Purchase,0.0,148485.54,890913.27
2021-09-06,Tax,0.0,445456.64,445456.64
2021-09-06,Commission,193878.1,0.0,639334.74
2021-09-06,Interest,15.0,0.0,639349.74
2021-09-06,RTGS,0.0,79918.72,559431.02
2021-09-06,Purchase,0.0,559431.02,0.0
2021-09-06,NEFT,5.0,0.0,5.0
2021-09-06,Interest,63305.0,0.0,63310.0
2021-09-06,Tax,0.0,31655.0,31655.0
2021-09-06,Debit Card,13386.0,0.0,45041.0
2021-09-06,Purchase,7.0,0.0,45048.0
2021-09-07,Reversal,44.32,0.0,45092.32
2021-09-07,Reversal,0.0,5636.54,39455.78
2021-09-07,Reversal,0.0,9863.95,29591.84
2021-09-07,Interest,141.0,0.0,29732.84
2021-09-07,NEFT,2726.0,0.0,32458.84
2021-09-07,Commission,31.98,0.0,32490.82
2021-09-07,Commission,0.0,16245.41,16245.41
2021-09-07,Bill,4.43,0.0,16249.84
2021-09-07,Purchase,34.92,0.0,16284.76
2021-09-07,Tax,556.0,0.0,16840.76
2021-09-07,Bill,3317.73,0.0,20158.49
2021-09-07,Debit Card,2.54,0.0,20161.03
2021-09-07,Purchase,9.0,0.0,20170.03
2021-09-07,RTGS,302.0,0.0,20472.03
2021-09-07,Purchase,95.9,0.0,20567.93
2021-09-07,Reversal,0.0,10283.97,10283.96
2021-09-07,RTGS,0.0,1028.4,9255.56
2021-09-07,Miscellaneous,129644.56,0.0,138900.12
2021-09-07,IMPS,0.0,15433.35,123466.77
2021-09-07,Commission,4043.47,0.0,127510.24
2021-09-07,Interest,27987.4,0.0,155497.64
2021-09-07,Purchase,5.4,0.0,155503.04
2021-09-07,Cash,0.0,31100.61,124402.43
2021-09-07,RTGS,845.3,0.0,125247.73
2021-09-07,Cash,0.0,62623.87,62623.86
2021-09-07,ATM,0.0,8946.27,53677.59
2021-09-07,Bill,0.0,26838.8,26838.8
2021-09-07,Bill,0.0,2982.09,23856.71
2021-09-07,RTGS,560480.0,0.0,584336.71
2021-09-07,Miscellaneous,0.0,194778.9,389557.81
2021-09-07,Tax,5968.58,0.0,395526.39
2021-09-07,Tax,248.92,0.0,395775.31
2021-09-07,Bill,179730.34,0.0,575505.65
2021-09-07,Debit Card,0.0,63945.07,511560.58
2021-09-07,Purchase,0.0,102312.12,409248.46
2021-09-07,Cash,483.21,0.0,409731.67
2021-09-08,Purchase,2465.6,0.0,412197.27
2021-09-08,Cheque,2.0,0.0,412199.27
2021-09-08,Transfer,0.0,41219.93,370979.34
2021-09-08,ATM,2.7,0.0,370982.04
2021-09-08,RTGS,0.0,37098.2,333883.84
2021-09-08,Purchase,0.0,111294.61,222589.23
2021-09-08,ATM,0.68,0.0,222589.91
2021-09-08,Purchase,93504.0,0.0,316093.91
